cell_set_accession	cell_label	cell_fullname	parent_cell_set_accession	parent_cell_set_name	labelset	cell_ontology_term_id	cell_ontology_term	rationale	rationale_dois	marker_gene_evidence	synonyms	cluster_size	NSF_marker_count	NSForest_markers	binary_genes	donor_composition	donor_composition_alert_0.90	library_composition_alert_0.95	library_composition_over0.01	dominant_library_percentage	dominant_library_info	roi_composition	roi_composition_alert_0.95	cluster_median_level1.class_scANVI_AIT11.6_round1_entropy	cluster_median_level2.neighborhood_scANVI_AIT11.6_round1_entropy	cluster_median_level1.class_scANVI_AIT11.6_round2_entropy	cluster_median_level2.neighborhood_scANVI_AIT11.6_round2_entropy	cluster_median_level3.subclass_scANVI_AIT11.6_round2_entropy	cluster_median_doublet_score	cluster_median_pct_counts_mt	gene_counts	umi_counts	umi_gene_ratio
AIT117_1	IN_1		AIT117_313	SN STH GABA	cluster							95	4	['SST', 'RMST', 'GRIK1', 'TCF7L2']	['SST', 'RMST', 'AC108169.1', 'GRIK1', 'HMGCS1', 'TCF7L2', 'LRRC3B', 'AC008415.1', 'AC013287.1', 'TSHZ2']	H20.30.002(0.9474)| H23.30.001(0.0316)| H20.30.001(0.0211)| H18.30.001(0.0)| H19.30.004(0.0)	Cautious	Balanced	1458_A09 (0.9053)|1169_A01 (0.0421)|2058_C03 (0.0105)|2012_B05 (0.0105)|1001_A06 (0.0105)|1233_A02 (0.0105)|2016_A03 (0.0105)	0.9053	1458_A09 (0.9053)|a total of 1490 cells in this dominant library	STH(0.9474)| SN(0.0211)| GPi(0.0211)| SN-VTA(0.0105)| CaT(0.0)| CaH(0.0)| CaB(0.0)| GPeR(0.0)| GPeC(0.0)| GPe(0.0)| NAC(0.0)| PuPV(0.0)| PuC(0.0)| Pu(0.0)| PuR(0.0)	Balanced	0	0.64	0	0.5	0.5	0.0267	0.4436	3298	6619	2.01
AIT117_2	IN_2		AIT117_314	SN STH VTA Glut	cluster							167	2	['SHOX2', 'LHX9']	['SHOX2', 'SHOX', 'LHX9', 'AC016766.1', 'LHX2', 'ADCYAP1', 'AL591463.1', 'AL161629.1', 'AL122014.1', 'AC113414.1']	H20.30.002(0.9521)| H19.30.004(0.0299)| H23.30.001(0.012)| H18.30.001(0.006)| H20.30.001(0.0)	Cautious	Balanced	1458_A09 (0.8683)|1169_A01 (0.0838)|1468_A09 (0.0299)	0.8683	1458_A09 (0.8683)|a total of 1490 cells in this dominant library	STH(0.988)| SN(0.006)| GPi(0.006)| CaT(0.0)| GPe(0.0)| CaH(0.0)| CaB(0.0)| GPeR(0.0)| GPeC(0.0)| NAC(0.0)| Pu(0.0)| PuPV(0.0)| PuC(0.0)| PuR(0.0)| SN-VTA(0.0)	Cautious	0	0	0	0	0	0.16	0.4314	9155	50906	5.56
AIT117_3	IN_3		AIT117_314	SN STH VTA Glut	cluster							112	2	['LINC02347', 'SIM1']	['DAPL1', 'LINC02196', 'LINC02347', 'SIM1', 'CPNE9', 'ADCYAP1', 'LHX1-DT', 'AC018467.1', 'DDX60L', 'HTR7']	H23.30.001(0.625)| H20.30.002(0.3036)| H19.30.004(0.0625)| H20.30.001(0.0089)| H18.30.001(0.0)	Balanced	Balanced	2058_C03 (0.5268)|1169_A01 (0.1786)|1458_A09 (0.1250)|2058_B03 (0.0714)|1468_A09 (0.0625)|2013_C01 (0.0179)	0.5268	2058_C03 (0.5268)|a total of 4967 cells in this dominant library	SN(0.5268)| STH(0.4375)| CaB(0.0179)| GPi(0.0179)| GPe(0.0)| CaT(0.0)| CaH(0.0)| GPeR(0.0)| GPeC(0.0)| NAC(0.0)| Pu(0.0)| PuPV(0.0)| PuC(0.0)| PuR(0.0)| SN-VTA(0.0)	Balanced	0	0	0	0	0	0.09	0.2447	6828.5	25948	3.8
AIT117_4	IN_4		AIT117_314	SN STH VTA Glut	cluster							130	3	['AL158154.3', 'AL356488.2', 'SLC26A3']	['AL158154.3', 'AL356488.2', 'C5orf63', 'SLC26A3', 'LINC00893', 'AL031658.1', 'TTF2', 'AC105402.3', 'MT-ATP8', 'PLP1']	H23.30.001(0.9308)| H20.30.002(0.0462)| H19.30.004(0.0154)| H20.30.001(0.0077)| H18.30.001(0.0)	Cautious	Balanced	2058_C03 (0.6154)|2058_B03 (0.2154)|2013_B01 (0.0385)|2012_B05 (0.0308)|2016_A03 (0.0231)|1169_A01 (0.0231)|1458_A09 (0.0231)|1468_A09 (0.0154)	0.6154	2058_C03 (0.6154)|a total of 4967 cells in this dominant library	SN(0.6154)| STH(0.2769)| GPi(0.1077)| CaT(0.0)| GPe(0.0)| CaH(0.0)| CaB(0.0)| GPeR(0.0)| GPeC(0.0)| NAC(0.0)| Pu(0.0)| PuPV(0.0)| PuC(0.0)| PuR(0.0)| SN-VTA(0.0)	Balanced	0	0	0	0.12	0.12	0.084	0.6749	4958	12160.5	2.45
AIT117_6	IN_6		AIT117_315	STR Cholinergic GABA	cluster							97	2	['HDC', 'PPP1R1C']	['HDC', 'MIR3663HG', 'SLC18A2', 'QRFPR', 'RSPO2', 'PPP1R1C', 'NEB', 'LINC01776', 'MCTP2', 'MEGF11']	H23.30.001(0.8969)| H19.30.004(0.1031)| H18.30.001(0.0)| H20.30.001(0.0)| H20.30.002(0.0)	Balanced	Balanced	2058_C03 (0.8969)|1468_A09 (0.1031)	0.8969	2058_C03 (0.8969)|a total of 4967 cells in this dominant library	SN(0.8969)| STH(0.1031)| CaB(0.0)| GPe(0.0)| GPeC(0.0)| CaH(0.0)| CaT(0.0)| GPi(0.0)| GPeR(0.0)| NAC(0.0)| Pu(0.0)| PuPV(0.0)| PuC(0.0)| PuR(0.0)| SN-VTA(0.0)	Balanced	0	0	0	0	0	0.16	0.0732	6919	25134	3.63
AIT117_7	IN_7		AIT117_316	NDB SI LHX8 GABA	cluster							67	3	['MAP3K15', 'MBNL3', 'DLK1']	['GAL', 'MAP3K15', 'AC127526.2', 'MBNL3', 'DLK1', 'HMX3', 'AC010478.1', 'PGR-AS1', 'ECEL1', 'ISL1']	H23.30.001(0.9254)| H20.30.001(0.0597)| H19.30.004(0.0149)| H18.30.001(0.0)| H20.30.002(0.0)	Cautious	Balanced	2058_C03 (0.4478)|2058_B03 (0.3134)|2013_B01 (0.1642)|960_B03 (0.0448)|1468_A09 (0.0149)|1482_A03 (0.0149)	0.4478	2058_C03 (0.4478)|a total of 4967 cells in this dominant library	SN(0.4478)| STH(0.3284)| GPi(0.1791)| GPeR(0.0448)| CaH(0.0)| CaT(0.0)| CaB(0.0)| GPe(0.0)| GPeC(0.0)| NAC(0.0)| Pu(0.0)| PuPV(0.0)| PuC(0.0)| PuR(0.0)| SN-VTA(0.0)	Balanced	0	0.69	0	0.76	0.76	0.0897	0.0563	9171	75788	8.26
AIT117_8	IN_8		AIT117_317	SN STH PVALB PITX2 Glut	cluster							506	3	['NTS', 'PVALB', 'LGALS1']	['CCN3', 'NTS', 'PVALB', 'PITX2', 'LGALS1', 'LMX1A', 'TTC6', 'BTNL9', 'GRB14', 'TRPC3']	H20.30.002(0.9862)| H19.30.004(0.0079)| H23.30.001(0.004)| H20.30.001(0.002)| H18.30.001(0.0)	Cautious	Balanced	1169_A01 (0.9289)|1458_A09 (0.0573)	0.9289	1169_A01 (0.9289)|a total of 7392 cells in this dominant library	STH(0.9941)| GPi(0.0059)| CaH(0.0)| CaT(0.0)| GPe(0.0)| GPeC(0.0)| CaB(0.0)| GPeR(0.0)| NAC(0.0)| PuC(0.0)| Pu(0.0)| PuPV(0.0)| PuR(0.0)| SN(0.0)| SN-VTA(0.0)	Cautious	0	0	0	0	0	0.06	0.235	6666.5	26559.5	3.98
AIT117_9	IN_9		AIT117_314	SN STH VTA Glut	cluster							191	2	['NTS', 'EBF3']	['LINC01482', 'FAM20A', 'EBF2', 'AC009975.1', 'NTS', 'EBF3', 'PITX2', 'ADCYAP1', 'NTNG2', 'AL592156.2']	H20.30.002(0.5654)| H19.30.004(0.288)| H23.30.001(0.1414)| H18.30.001(0.0052)| H20.30.001(0.0)	Balanced	Balanced	1169_A01 (0.5026)|1468_A09 (0.2880)|1458_A09 (0.0628)|2058_B03 (0.0576)|2058_C03 (0.0366)|2012_B05 (0.0314)|2016_A03 (0.0105)	0.5026	1169_A01 (0.5026)|a total of 7392 cells in this dominant library	STH(0.911)| GPi(0.0471)| SN(0.0419)| CaT(0.0)| GPe(0.0)| CaH(0.0)| CaB(0.0)| GPeR(0.0)| GPeC(0.0)| NAC(0.0)| Pu(0.0)| PuPV(0.0)| PuC(0.0)| PuR(0.0)| SN-VTA(0.0)	Balanced	0	0	0	0	0	0.1373	0.1796	6528	25990	3.98
AIT117_10	IN_10		AIT117_317	SN STH PVALB PITX2 Glut	cluster							302	3	['LMX1A', 'MCHR2', 'RORB']	['NTS', 'PITX2', 'LMX1A', 'LINC01435', 'MCHR2', 'RORB', 'NDST4', 'LINC00299', 'KCNMB2', 'KCNMB2-AS1']	H20.30.002(0.9205)| H19.30.004(0.0364)| H23.30.001(0.0232)| H18.30.001(0.0199)| H20.30.001(0.0)	Cautious	Balanced	1169_A01 (0.8974)|1468_A09 (0.0331)|1458_A09 (0.0232)|925_F03 (0.0199)	0.8974	1169_A01 (0.8974)|a total of 7392 cells in this dominant library	STH(0.9669)| SN(0.0232)| GPi(0.0099)| CaT(0.0)| GPe(0.0)| CaH(0.0)| CaB(0.0)| GPeR(0.0)| GPeC(0.0)| NAC(0.0)| Pu(0.0)| PuPV(0.0)| PuC(0.0)| PuR(0.0)| SN-VTA(0.0)	Cautious	0	0	0	0	0	0.07	0.3079	6153	24035.5	3.91
AIT117_11	IN_11		AIT117_317	SN STH PVALB PITX2 Glut	cluster							897	3	['NDNF', 'PITX2', 'LMX1A']	['NDNF', 'NTS', 'PITX2', 'AL359915.1', 'LMX1A', 'CDH23', 'TTC6', 'KCNMB2', 'KLHL1', 'RASGEF1B']	H20.30.002(0.932)| H23.30.001(0.0658)| H18.30.001(0.0022)| H20.30.001(0.0)| H19.30.004(0.0)	Cautious	Balanced	1169_A01 (0.9264)|2058_C03 (0.0334)|2058_B03 (0.0234)	0.9264	1169_A01 (0.9264)|a total of 7392 cells in this dominant library	STH(0.9554)| SN(0.0357)| GPi(0.0078)| GPe(0.0011)| CaH(0.0)| CaT(0.0)| CaB(0.0)| GPeR(0.0)| GPeC(0.0)| NAC(0.0)| Pu(0.0)| PuPV(0.0)| PuC(0.0)| PuR(0.0)| SN-VTA(0.0)	Cautious	0	0	0	0	0	0.08	0.2176	6245	27995	4.48
AIT117_12	IN_12		AIT117_318	SN STH GATA3 TCF7L2 GABA	cluster							331	3	['GATA3', 'LHX1-DT', 'PDE11A']	['GATA3', 'LHX1', 'LHX5-AS1', 'LHX1-DT', 'CORIN', 'PDE11A', 'LINC01630', 'ID4', 'ST8SIA6', 'TCERG1L']	H20.30.002(0.9003)| H20.30.001(0.0634)| H23.30.001(0.0211)| H19.30.004(0.0121)| H18.30.001(0.003)	Cautious	Balanced	1169_A01 (0.6284)|1458_A09 (0.2719)|1001_A06 (0.0574)|1468_A09 (0.0121)	0.6284	1169_A01 (0.6284)|a total of 7392 cells in this dominant library	STH(0.9154)| SN-VTA(0.0574)| GPi(0.0181)| SN(0.006)| GPe(0.003)| CaT(0.0)| CaB(0.0)| GPeR(0.0)| GPeC(0.0)| CaH(0.0)| NAC(0.0)| PuPV(0.0)| PuC(0.0)| Pu(0.0)| PuR(0.0)	Balanced	0	0.5	0	0.58	0.58	0.12	0.2575	6981	30378	4.35
AIT117_13	IN_13		AIT117_313	SN STH GABA	cluster							101	2	['LINC01210', 'NPFFR2']	['LINC02315', 'LINC01568', 'LINC01210', 'GATA3', 'AC018467.1', 'NPFFR2', 'AC083870.1', 'CPED1', 'AC019211.1', 'NRP1']	H20.30.002(0.8911)| H19.30.004(0.0495)| H23.30.001(0.0396)| H20.30.001(0.0198)| H18.30.001(0.0)	Balanced	Balanced	1169_A01 (0.6436)|1458_A09 (0.2475)|1468_A09 (0.0396)|2013_B01 (0.0297)|1233_A02 (0.0198)	0.6436	1169_A01 (0.6436)|a total of 7392 cells in this dominant library	STH(0.9406)| GPi(0.0396)| SN(0.0198)| CaT(0.0)| GPe(0.0)| CaH(0.0)| CaB(0.0)| GPeR(0.0)| GPeC(0.0)| NAC(0.0)| Pu(0.0)| PuPV(0.0)| PuC(0.0)| PuR(0.0)| SN-VTA(0.0)	Balanced	0	0.64	0	0.58	0.58	0.1029	0.2226	5694	18932	3.32
AIT117_14	IN_14		AIT117_319	SN PVALB GATA3 GABA	cluster							78	3	['LINC01060', 'ST8SIA6-AS1', 'PNOC']	['LINC01060', 'ST8SIA6-AS1', 'LINC01202', 'GATA2-AS1', 'PNOC', 'PVALB', 'GATA3', 'LHX1', 'SLC30A3', 'COBLL1']	H18.30.001(0.3846)| H19.30.004(0.3846)| H20.30.002(0.1795)| H23.30.001(0.0385)| H20.30.001(0.0128)	Balanced	Balanced	1468_A09 (0.3846)|925_F03 (0.3846)|1458_A09 (0.1410)|1169_A01 (0.0385)|2058_C03 (0.0256)|2012_A05 (0.0128)|1233_A02 (0.0128)	0.3846	925_F03 (0.3846)|a total of 3479 cells in this dominant library	STH(0.5641)| SN(0.4231)| GPe(0.0128)| CaT(0.0)| GPeC(0.0)| CaH(0.0)| CaB(0.0)| GPi(0.0)| GPeR(0.0)| NAC(0.0)| Pu(0.0)| PuPV(0.0)| PuC(0.0)| PuR(0.0)| SN-VTA(0.0)	Balanced	0	0.32	0	0.39	0.49	0.1384	0.1926	9454	58788	6.22
AIT117_15	IN_15		AIT117_313	SN STH GABA	cluster							113	4	['AL354771.1', 'SLC5A8', 'KAZN-AS1', 'AP003464.1']	['AC119868.2', 'AL354771.1', 'SLC5A8', 'AC139720.1', 'KAZN-AS1', 'AP003464.1', 'AC117461.1', 'KLHL1', 'PCDH11Y', 'RMST']	H20.30.001(0.7168)| H23.30.001(0.1504)| H20.30.002(0.1239)| H19.30.004(0.0088)| H18.30.001(0.0)	Balanced	Balanced	1233_A02 (0.6637)|1169_A01 (0.1239)|2058_C03 (0.0708)|960_B03 (0.0442)|2013_B01 (0.0354)|2058_B03 (0.0354)	0.6637	1233_A02 (0.6637)|a total of 4017 cells in this dominant library	SN(0.7345)| STH(0.1681)| GPi(0.0442)| GPeR(0.0442)| SN-VTA(0.0088)| CaT(0.0)| CaB(0.0)| GPe(0.0)| GPeC(0.0)| CaH(0.0)| NAC(0.0)| PuPV(0.0)| PuC(0.0)| Pu(0.0)| PuR(0.0)	Balanced	0	0.5	0	0.58	0.58	0.1039	0.0282	4201	11695	2.78
AIT117_16	IN_16		AIT117_314	SN STH VTA Glut	cluster							251	4	['PANCR', 'EBF3', 'PITX2', 'LMX1A']	['PANCR', 'AC009975.1', 'EBF3', 'PITX2', 'LMX1B', 'LMX1A', 'TTC6', 'CDH23', 'DIRAS3', 'NDST4']	H20.30.002(0.749)| H19.30.004(0.1873)| H23.30.001(0.0598)| H20.30.001(0.004)| H18.30.001(0.0)	Balanced	Balanced	1169_A01 (0.7012)|1468_A09 (0.1833)|1458_A09 (0.0478)|2058_B03 (0.0359)|2058_C03 (0.0239)	0.7012	1169_A01 (0.7012)|a total of 7392 cells in this dominant library	STH(0.9721)| SN(0.0279)| CaB(0.0)| GPe(0.0)| GPeC(0.0)| CaH(0.0)| CaT(0.0)| GPi(0.0)| GPeR(0.0)| NAC(0.0)| Pu(0.0)| PuPV(0.0)| PuC(0.0)| PuR(0.0)| SN-VTA(0.0)	Cautious	0	0	0	0	0	0.11	0.1589	6387	25200	3.95
AIT117_17	IN_17		AIT117_314	SN STH VTA Glut	cluster							93	4	['AC079148.3', 'FAM9B', 'KCNS3', 'ANGPT1']	['AC079148.3', 'AC007091.1', 'LMX1B', 'FAM9B', 'KCNS3', 'ANGPT1', 'SLC17A6', 'CRNDE', 'LPAR1', 'KCNH8']	H20.30.002(0.7527)| H19.30.004(0.2366)| H23.30.001(0.0108)| H18.30.001(0.0)| H20.30.001(0.0)	Balanced	Balanced	1169_A01 (0.6237)|1468_A09 (0.2366)|1458_A09 (0.1290)|2058_B03 (0.0108)	0.6237	1169_A01 (0.6237)|a total of 7392 cells in this dominant library	STH(1.0)| CaH(0.0)| CaB(0.0)| GPe(0.0)| GPeC(0.0)| GPeR(0.0)| CaT(0.0)| GPi(0.0)| NAC(0.0)| PuC(0.0)| Pu(0.0)| PuPV(0.0)| PuR(0.0)| SN(0.0)| SN-VTA(0.0)	Cautious	0	0	0	0	0	0.0784	0.1572	5642	19087	3.38
AIT117_18	IN_18		AIT117_314	SN STH VTA Glut	cluster							98	3	['ANGPT1', 'CRNDE', 'SEMA3E']	['LMX1B', 'LMX1A', 'SLITRK6', 'ANGPT1', 'CRNDE', 'SEMA3E', 'GABRG1', 'SPHKAP', 'COL21A1', 'KLHL1']	H20.30.002(0.8571)| H23.30.001(0.0714)| H19.30.004(0.0714)| H18.30.001(0.0)| H20.30.001(0.0)	Balanced	Balanced	1169_A01 (0.8571)|2058_B03 (0.0714)|1468_A09 (0.0510)|1279_A07 (0.0204)	0.8571	1169_A01 (0.8571)|a total of 7392 cells in this dominant library	STH(1.0)| CaH(0.0)| CaB(0.0)| GPe(0.0)| GPeC(0.0)| GPeR(0.0)| CaT(0.0)| GPi(0.0)| NAC(0.0)| PuC(0.0)| Pu(0.0)| PuPV(0.0)| PuR(0.0)| SN(0.0)| SN-VTA(0.0)	Cautious	0	0	0	0	0	0.08	0.1668	5531.5	17929.5	3.24
AIT117_19	IN_19		AIT117_314	SN STH VTA Glut	cluster							233	2	['LMX1A', 'ADAMTSL1']	['HPGD', 'ADCYAP1', 'LMX1A', 'AP000829.1', 'AL356295.1', 'ADAMTSL1', 'CRNDE', 'POU6F2', 'BMPR1B', 'AC007368.1']	H20.30.002(0.9013)| H19.30.004(0.0815)| H23.30.001(0.0172)| H18.30.001(0.0)| H20.30.001(0.0)	Cautious	Balanced	1169_A01 (0.8541)|1468_A09 (0.0815)|1458_A09 (0.0472)|2013_B01 (0.0129)	0.8541	1169_A01 (0.8541)|a total of 7392 cells in this dominant library	STH(0.9871)| GPi(0.0129)| CaH(0.0)| CaT(0.0)| GPe(0.0)| GPeC(0.0)| CaB(0.0)| GPeR(0.0)| NAC(0.0)| PuC(0.0)| Pu(0.0)| PuPV(0.0)| PuR(0.0)| SN(0.0)| SN-VTA(0.0)	Cautious	0	0	0	0	0	0.11	0.181	5788	19670	3.4
AIT117_23	IN_23		AIT117_320	TH MEIS2 OTX2 GABA	cluster							1497	2	['NPSR1', 'OTX2-AS1']	['CASR', 'NPSR1', 'OTX2', 'OTX2-AS1', 'LINC01210', 'LINC02253', 'AL390957.1', 'SPHKAP', 'CHRM2', 'GALNT14']	H20.30.002(0.5337)| H20.30.001(0.191)| H23.30.001(0.1349)| H19.30.004(0.0915)| H18.30.001(0.0488)	Balanced	Balanced	1169_A01 (0.5077)|1001_A06 (0.1102)|1233_A02 (0.0655)|925_F03 (0.0414)|1468_A09 (0.0387)|2058_B03 (0.0321)|1279_B07 (0.0294)|2016_A03 (0.0274)|2013_B01 (0.0267)|1279_A07 (0.0234)|2012_B05 (0.0187)|1458_A09 (0.0147)	0.5077	1169_A01 (0.5077)|a total of 7392 cells in this dominant library	STH(0.6506)| SN-VTA(0.1202)| SN(0.1169)| GPi(0.0888)| GPe(0.012)| CaT(0.004)| GPeR(0.0033)| PuPV(0.002)| NAC(0.0013)| CaB(0.0007)| CaH(0.0)| GPeC(0.0)| Pu(0.0)| PuC(0.0)| PuR(0.0)	Balanced	0	0	0	0	0	0.06	0.233	4815	16535	3.43
AIT117_24	IN_24		AIT117_320	TH MEIS2 OTX2 GABA	cluster							201	4	['DMBX1', 'CPLX3', 'OTX2', 'GATA3']	['DMBX1', 'CPLX3', 'OTX2', 'GATA3', 'GNG3', 'SEMA3C', 'NR2F2', 'TUBB', 'HMGCS1', 'H3F3B']	H20.30.001(0.3881)| H19.30.004(0.3682)| H20.30.002(0.1891)| H23.30.001(0.0299)| H18.30.001(0.0249)	Balanced	Balanced	1001_A06 (0.3831)|1468_A09 (0.2935)|1169_A01 (0.1244)|1279_B07 (0.0398)|1001_B06 (0.0398)|1279_A07 (0.0348)|1458_A09 (0.0249)|925_F03 (0.0149)	0.3831	1001_A06 (0.3831)|a total of 3218 cells in this dominant library	STH(0.5373)| SN-VTA(0.4229)| GPi(0.0199)| SN(0.0199)| CaT(0.0)| CaH(0.0)| CaB(0.0)| GPeR(0.0)| GPeC(0.0)| GPe(0.0)| NAC(0.0)| PuPV(0.0)| PuC(0.0)| Pu(0.0)| PuR(0.0)	Balanced	0	0	0	0	0	0.0784	0.7517	5780	19806	3.43
AIT117_25	IN_25		AIT117_320	TH MEIS2 OTX2 GABA	cluster							446	3	['LINC01210', 'TSPAN18', 'SEMA3C']	['OTX2-AS1', 'LINC01210', 'TSPAN18', 'LINC02055', 'PRSS12', 'SEMA3C', 'CRNDE', 'SPHKAP', 'GALNT14', 'EPB41L4A']	H23.30.001(0.3341)| H20.30.002(0.3229)| H20.30.001(0.1906)| H19.30.004(0.1435)| H18.30.001(0.009)	Balanced	Balanced	1169_A01 (0.2960)|2013_B01 (0.1413)|1001_A06 (0.1143)|1468_A09 (0.1099)|2058_B03 (0.0987)|2058_C03 (0.0426)|1482_A03 (0.0381)|1233_A02 (0.0314)|1279_B07 (0.0224)|1458_A09 (0.0179)|2016_A03 (0.0157)|2012_B05 (0.0157)|1279_A07 (0.0112)	0.296	1169_A01 (0.296)|a total of 7392 cells in this dominant library	STH(0.5583)| GPi(0.2242)| SN-VTA(0.1233)| SN(0.0807)| GPe(0.0045)| CaB(0.0045)| GPeR(0.0022)| CaT(0.0022)| CaH(0.0)| GPeC(0.0)| NAC(0.0)| PuPV(0.0)| PuC(0.0)| Pu(0.0)| PuR(0.0)	Balanced	0	0	0	0	0	0.0588	0.1411	5192.5	19242	3.71
AIT117_26	IN_26		AIT117_320	TH MEIS2 OTX2 GABA	cluster							164	3	['OTX2-AS1', 'MOBP', 'RNF220']	['OTX2-AS1', 'MOBP', 'TF', 'SPHKAP', 'RNF220', 'AC079352.1', 'ST18', 'TMEM144', 'DOCK5', 'PLP1']	H23.30.001(0.5122)| H20.30.002(0.2195)| H20.30.001(0.1768)| H18.30.001(0.0488)| H19.30.004(0.0427)	Balanced	Balanced	2058_C03 (0.2500)|1169_A01 (0.1951)|2016_A03 (0.1341)|994_C03 (0.1037)|2058_B03 (0.0427)|1233_A02 (0.0366)|2013_B01 (0.0305)|1468_A09 (0.0305)|1001_A06 (0.0244)|2012_B05 (0.0244)|1075_B04 (0.0183)|925_F03 (0.0183)|2018_D01 (0.0122)|2013_C01 (0.0122)|1001_B06 (0.0122)	0.25	2058_C03 (0.25)|a total of 4967 cells in this dominant library	GPi(0.3232)| SN(0.3049)| STH(0.3049)| SN-VTA(0.0366)| CaB(0.0122)| GPe(0.0061)| CaT(0.0061)| PuPV(0.0061)| GPeR(0.0)| CaH(0.0)| GPeC(0.0)| PuC(0.0)| Pu(0.0)| NAC(0.0)| PuR(0.0)	Balanced	0	0	0	0	0	0.1206	0.0838	4140.5	11503	2.78
AIT117_27	IN_27		AIT117_320	TH MEIS2 OTX2 GABA	cluster							289	2	['PRSS12', 'HHIP']	['OTX2-AS1', 'LINC01210', 'PRSS12', 'GLYATL2', 'HHIP', 'GREM2', 'GRIK1', 'VWC2L', 'CADPS2', 'UNC13C']	H20.30.002(0.4637)| H19.30.004(0.2249)| H20.30.001(0.1696)| H23.30.001(0.1107)| H18.30.001(0.0311)	Balanced	Balanced	1169_A01 (0.4256)|1468_A09 (0.1938)|1001_A06 (0.1384)|2058_C03 (0.0381)|1001_B06 (0.0346)|925_F03 (0.0277)|2013_B01 (0.0277)|1482_A03 (0.0242)|1279_A07 (0.0208)|2058_B03 (0.0208)|2016_A03 (0.0104)|2012_B05 (0.0104)|1279_B07 (0.0104)	0.4256	1169_A01 (0.4256)|a total of 7392 cells in this dominant library	STH(0.6782)| SN-VTA(0.173)| GPi(0.0761)| SN(0.0727)| CaT(0.0)| CaH(0.0)| CaB(0.0)| GPeR(0.0)| GPeC(0.0)| GPe(0.0)| NAC(0.0)| PuPV(0.0)| PuC(0.0)| Pu(0.0)| PuR(0.0)	Balanced	0	0	0	0	0	0.0588	0.226	4054	11636	2.87
AIT117_29	IN_29		AIT117_314	SN STH VTA Glut	cluster							111	2	['PAX7', 'FBN2']	['PAX7', 'SIM1', 'AC079148.3', 'BDNF', 'KCNS3', 'FBN2', 'STK32B', 'SLC27A6', 'LINC00299', 'RMST']	H20.30.002(0.982)| H19.30.004(0.018)| H18.30.001(0.0)| H20.30.001(0.0)| H23.30.001(0.0)	Cautious	Balanced	1169_A01 (0.9369)|1458_A09 (0.0450)|1468_A09 (0.0180)	0.9369	1169_A01 (0.9369)|a total of 7392 cells in this dominant library	STH(1.0)| CaH(0.0)| CaB(0.0)| GPe(0.0)| GPeC(0.0)| GPeR(0.0)| CaT(0.0)| GPi(0.0)| NAC(0.0)| PuC(0.0)| Pu(0.0)| PuPV(0.0)| PuR(0.0)| SN(0.0)| SN-VTA(0.0)	Cautious	0	0	0	0	0	0.12	0.1946	5788	18890	3.26
AIT117_31	IN_31		AIT117_314	SN STH VTA Glut	cluster							372	3	['SIM1', 'AL110292.1', 'SLC17A6']	['SIM1', 'AC092640.1', 'AL110292.1', 'AP000829.1', 'SLC17A6', 'LINC00923', 'LINC00299', 'KCNH5', 'SCN7A', 'RMST']	H20.30.002(0.7957)| H23.30.001(0.1694)| H19.30.004(0.0323)| H20.30.001(0.0027)| H18.30.001(0.0)	Balanced	Balanced	1169_A01 (0.7769)|2058_C03 (0.0806)|2058_B03 (0.0699)|1468_A09 (0.0296)|1458_A09 (0.0188)|2013_B01 (0.0108)	0.7769	1169_A01 (0.7769)|a total of 7392 cells in this dominant library	STH(0.8978)| SN(0.0806)| GPi(0.0161)| GPe(0.0027)| SN-VTA(0.0027)| CaT(0.0)| CaB(0.0)| GPeR(0.0)| GPeC(0.0)| CaH(0.0)| NAC(0.0)| PuPV(0.0)| PuC(0.0)| Pu(0.0)| PuR(0.0)	Balanced	0	0.24	0	0.24	0.24	0.1	0.1276	5943.5	20476	3.45
AIT117_32	IN_32		AIT117_314	SN STH VTA Glut	cluster							154	4	['LINC01876', 'AC007091.1', 'LMX1A', 'TTC6']	['EBF2', 'EBF3', 'LINC01876', 'AC007091.1', 'LMX1A', 'TTC6', 'AC007614.1', 'AC132153.1', 'NOS1', 'RMST']	H23.30.001(0.3571)| H19.30.004(0.3506)| H20.30.002(0.2597)| H20.30.001(0.0325)| H18.30.001(0.0)	Balanced	Balanced	1468_A09 (0.3506)|1169_A01 (0.2597)|2058_C03 (0.1688)|2058_B03 (0.1429)|2013_B01 (0.0260)|1233_A02 (0.0260)|2016_A03 (0.0130)	0.3506	1468_A09 (0.3506)|a total of 3319 cells in this dominant library	STH(0.7532)| SN(0.1948)| GPi(0.039)| SN-VTA(0.0065)| Pu(0.0065)| CaH(0.0)| CaB(0.0)| GPeR(0.0)| GPeC(0.0)| GPe(0.0)| CaT(0.0)| PuPV(0.0)| PuC(0.0)| NAC(0.0)| PuR(0.0)	Balanced	0	0.32	0	0.39	0.39	0.1154	0.1773	6927.5	31228.5	4.51
AIT117_34	IN_34		AIT117_313	SN STH GABA	cluster							289	4	['LHX1', 'PRSS3', 'AL110292.1', 'ANGPT1']	['LHX1', 'LHX1-DT', 'CORIN', 'PRSS3', 'AL110292.1', 'ANGPT1', 'SCIN', 'AC007368.1', 'AGBL1', 'GREM2']	H20.30.002(0.8997)| H23.30.001(0.083)| H19.30.004(0.0173)| H18.30.001(0.0)| H20.30.001(0.0)	Balanced	Balanced	1169_A01 (0.7855)|1458_A09 (0.1142)|2013_B01 (0.0311)|2012_B05 (0.0242)|2058_B03 (0.0208)|1468_A09 (0.0138)	0.7855	1169_A01 (0.7855)|a total of 7392 cells in this dominant library	STH(0.9377)| GPi(0.0588)| GPe(0.0035)| CaT(0.0)| CaH(0.0)| GPeC(0.0)| CaB(0.0)| GPeR(0.0)| NAC(0.0)| PuC(0.0)| Pu(0.0)| PuPV(0.0)| PuR(0.0)| SN(0.0)| SN-VTA(0.0)	Balanced	0	0	0	0	0	0.1	0.2177	6454	24316	3.77
AIT117_35	IN_35		AIT117_313	SN STH GABA	cluster							112	4	['AC020584.1', 'LINC02315', 'ONECUT1', 'LINC00922']	['AC020584.1', 'PMFBP1', 'LINC02315', 'ONECUT1', 'LINC00922', 'PTH2R', 'MLIP', 'POU6F2', 'KCNH5', 'CNTN6']	H20.30.002(0.9732)| H23.30.001(0.0179)| H19.30.004(0.0089)| H18.30.001(0.0)| H20.30.001(0.0)	Cautious	Balanced	1169_A01 (0.8929)|1458_A09 (0.0804)|2013_B01 (0.0179)	0.8929	1169_A01 (0.8929)|a total of 7392 cells in this dominant library	STH(0.9821)| GPi(0.0179)| CaH(0.0)| CaT(0.0)| GPe(0.0)| GPeC(0.0)| CaB(0.0)| GPeR(0.0)| NAC(0.0)| PuC(0.0)| Pu(0.0)| PuPV(0.0)| PuR(0.0)| SN(0.0)| SN-VTA(0.0)	Cautious	0	0	0	0	0	0.13	0.2015	6760.5	26278.5	3.89
AIT117_36	IN_36		AIT117_313	SN STH GABA	cluster							89	3	['LINC02408', 'AL136962.1', 'AC020584.1']	['LINC02408', 'AL136962.1', 'AC020584.1', 'LINC00922', 'PTGER3', 'DIRAS3', 'PIEZO2', 'SYTL4', 'PDGFD', 'MCTP2']	H20.30.002(0.9888)| H23.30.001(0.0112)| H18.30.001(0.0)| H20.30.001(0.0)| H19.30.004(0.0)	Cautious	Balanced	1169_A01 (0.8202)|1458_A09 (0.1685)|2013_B01 (0.0112)	0.8202	1169_A01 (0.8202)|a total of 7392 cells in this dominant library	STH(0.9888)| GPi(0.0112)| CaH(0.0)| CaT(0.0)| GPe(0.0)| GPeC(0.0)| CaB(0.0)| GPeR(0.0)| NAC(0.0)| PuC(0.0)| Pu(0.0)| PuPV(0.0)| PuR(0.0)| SN(0.0)| SN-VTA(0.0)	Cautious	0	0	0	0	0	0.09	0.2791	5839	20755	3.55
AIT117_37	IN_37		AIT117_313	SN STH GABA	cluster							242	2	['AC114316.1', 'LINC02055']	['ONECUT3', 'PMFBP1', 'AC114316.1', 'ONECUT1', 'LHX1', 'LINC02055', 'PAX6', 'CDH23', 'CRHR2', 'POU6F2']	H20.30.002(0.7397)| H23.30.001(0.186)| H19.30.004(0.0496)| H20.30.001(0.0248)| H18.30.001(0.0)	Balanced	Balanced	1169_A01 (0.6860)|2013_B01 (0.1281)|1458_A09 (0.0537)|1468_A09 (0.0455)|2058_C03 (0.0289)|1233_A02 (0.0165)|2058_B03 (0.0165)	0.686	1169_A01 (0.686)|a total of 7392 cells in this dominant library	STH(0.8058)| GPi(0.1364)| SN(0.0455)| GPe(0.0041)| SN-VTA(0.0041)| GPeR(0.0041)| CaT(0.0)| GPeC(0.0)| CaB(0.0)| CaH(0.0)| NAC(0.0)| PuPV(0.0)| PuC(0.0)| Pu(0.0)| PuR(0.0)	Balanced	0	0	0	0	0	0.1	0.1241	6477.5	24273	3.75
AIT117_38	IN_38		AIT117_313	SN STH GABA	cluster							257	4	['LINC00922', 'AC079148.3', 'CDH23', 'KCNS3']	['LINC00922', 'AC079148.3', 'LHX1', 'CDH23', 'KCNS3', 'PDE11A', 'GPR139', 'POU6F2', 'C5orf64', 'AGBL1']	H20.30.002(0.9611)| H23.30.001(0.035)| H20.30.001(0.0039)| H18.30.001(0.0)| H19.30.004(0.0)	Cautious	Balanced	1169_A01 (0.9494)|2013_B01 (0.0233)|1458_A09 (0.0117)	0.9494	1169_A01 (0.9494)|a total of 7392 cells in this dominant library	STH(0.9689)| GPi(0.0233)| GPe(0.0039)| SN(0.0039)| CaH(0.0)| CaT(0.0)| CaB(0.0)| GPeR(0.0)| GPeC(0.0)| NAC(0.0)| Pu(0.0)| PuPV(0.0)| PuC(0.0)| PuR(0.0)| SN-VTA(0.0)	Cautious	0	0	0	0	0	0.1	0.1673	6327	23916	3.78
AIT117_40	IN_40		AIT117_313	SN STH GABA	cluster							95	2	['AL110292.1', 'AC092114.1']	['TMEM255A', 'ESR1', 'AL110292.1', 'PRSS3', 'AC092114.1', 'LYPD6B', 'NRP1', 'EPHA5-AS1', 'PLCH1', 'OCA2']	H23.30.001(0.9579)| H20.30.002(0.0316)| H20.30.001(0.0105)| H18.30.001(0.0)| H19.30.004(0.0)	Cautious	Balanced	2013_B01 (0.9263)|2012_B05 (0.0316)|988_C05 (0.0211)|1042_C06 (0.0105)|1169_A01 (0.0105)	0.9263	2013_B01 (0.9263)|a total of 4881 cells in this dominant library	GPi(0.9579)| CaT(0.0211)| NAC(0.0105)| STH(0.0105)| GPe(0.0)| CaH(0.0)| CaB(0.0)| GPeR(0.0)| GPeC(0.0)| PuC(0.0)| Pu(0.0)| PuPV(0.0)| PuR(0.0)| SN(0.0)| SN-VTA(0.0)	Cautious	0	0.88	0	0.93	0.93	0.0735	0.0421	8876	63597	7.17
AIT117_41	IN_41		AIT117_321	STR FS PTHLH ST18 GABA	cluster							74	3	['ETNPPL', 'IL1RAPL2', 'RANBP3L']	['OPN3', 'MYRFL', 'PDGFD', 'ETNPPL', 'IL1RAPL2', 'RANBP3L', 'AQP4', 'MRVI1', 'OBI1-AS1', 'BMPR1B']	H20.30.001(0.2973)| H20.30.002(0.2973)| H23.30.001(0.2568)| H18.30.001(0.1486)| H19.30.004(0.0)	Balanced	Balanced	1036_A03 (0.1486)|930_C05 (0.0811)|2018_E01 (0.0811)|1036_B03 (0.0811)|891_A06 (0.0541)|1036_C03 (0.0541)|988_E05 (0.0541)|1042_A06 (0.0541)|1955_B06 (0.0405)|847_A04 (0.0405)|1042_B06 (0.0405)|980_C02 (0.0405)|2018_B01 (0.0270)|1955_C06 (0.0270)|2018_A01 (0.0270)|988_D05 (0.0270)|897_E03 (0.0135)|1959_C02 (0.0135)|1959_A02 (0.0135)|2006_B05 (0.0135)|1458_A09 (0.0135)|1110_B07 (0.0135)|1110_A07 (0.0135)|2016_B03 (0.0135)|822_B01 (0.0135)	0.1486	1036_A03 (0.1486)|a total of 10559 cells in this dominant library	NAC(0.4189)| CaH(0.1622)| CaT(0.1486)| PuPV(0.0946)| CaB(0.0676)| PuC(0.0405)| Pu(0.0405)| STH(0.0135)| GPe(0.0135)| GPeC(0.0)| GPeR(0.0)| GPi(0.0)| PuR(0.0)| SN(0.0)| SN-VTA(0.0)	Balanced	0	0.24	0	0.12	0.12	0.1	0.1537	7005.5	27109.5	3.87
AIT117_44	IN_44		AIT117_322	STR TAC3 PLPP4 GABA	cluster							76	3	['CHRNA3', 'GLP1R', 'TBXAS1']	['CHRNA3', 'LINC01837', 'GLP1R', 'TAC3', 'CRABP1', 'TBXAS1', 'ADAM28', 'AC007614.1', 'FYB1', 'IKZF1']	H23.30.001(0.3026)| H20.30.001(0.2763)| H18.30.001(0.2237)| H20.30.002(0.1974)| H19.30.004(0.0)	Balanced	Balanced	980_C02 (0.1053)|1955_C06 (0.0658)|988_D05 (0.0658)|2012_A05 (0.0526)|847_A04 (0.0526)|1036_C03 (0.0526)|891_A06 (0.0526)|897_E03 (0.0395)|988_E05 (0.0395)|822_A01 (0.0395)|930_D05 (0.0395)|930_C05 (0.0263)|1110_A07 (0.0263)|930_E05 (0.0263)|1955_B06 (0.0263)|1959_A02 (0.0263)|1036_B03 (0.0263)|1036_A03 (0.0263)|2018_B01 (0.0263)|2018_A01 (0.0263)|822_B01 (0.0132)|847_C04 (0.0132)|2016_B03 (0.0132)|1042_A06 (0.0132)|2018_E01 (0.0132)|988_C05 (0.0132)|930_F05 (0.0132)|1959_B02 (0.0132)|858_D03 (0.0132)|1959_C02 (0.0132)|2006_A05 (0.0132)|2013_B01 (0.0132)	0.1053	980_C02 (0.1053)|a total of 6906 cells in this dominant library	CaT(0.1974)| NAC(0.1711)| CaB(0.1316)| CaH(0.1184)| PuPV(0.0921)| PuC(0.0789)| Pu(0.0789)| PuR(0.0526)| GPe(0.0526)| GPi(0.0263)| GPeC(0.0)| GPeR(0.0)| SN(0.0)| SN-VTA(0.0)| STH(0.0)	Balanced	0	0	0	0	0	0.0656	0.148	6105	18557	3.04
AIT117_45	IN_45		AIT117_313	SN STH GABA	cluster							288	3	['ECEL1', 'SST', 'LINC02691']	['AC010478.1', 'ECEL1', 'ISL1', 'SST', 'LINC02691', 'MCHR2', 'ZBTB7C', 'NR2F2-AS1', 'KCNMB2', 'OPRM1']	H23.30.001(0.6111)| H20.30.002(0.2812)| H19.30.004(0.0694)| H20.30.001(0.0347)| H18.30.001(0.0035)	Balanced	Balanced	2013_B01 (0.2812)|1169_A01 (0.2014)|2012_B05 (0.1146)|2018_D01 (0.0903)|1458_A09 (0.0729)|1468_A09 (0.0694)|2016_A03 (0.0486)|1482_A03 (0.0312)|2058_B03 (0.0278)|2058_C03 (0.0243)|2013_C01 (0.0139)	0.2812	2013_B01 (0.2812)|a total of 4881 cells in this dominant library	GPi(0.5729)| STH(0.375)| SN(0.0243)| CaB(0.0139)| GPe(0.0104)| GPeR(0.0035)| CaH(0.0)| GPeC(0.0)| CaT(0.0)| NAC(0.0)| Pu(0.0)| PuPV(0.0)| PuC(0.0)| PuR(0.0)| SN-VTA(0.0)	Balanced	0	0.67	0	0.5	0.5	0.1176	0.0934	7603.5	36230.5	4.77
AIT117_47	IN_47		AIT117_323	NDB SI LHX6 LHX8 GBX1	cluster							87	3	['AC092110.1', 'LHX8', 'GALR1']	['GBX1', 'AC092110.1', 'LHX8', 'GALR1', 'AC124254.2', 'ELFN1', 'SEMA3E', 'GABRG1', 'TAFA1', 'AC023095.1']	H23.30.001(0.7816)| H20.30.001(0.1954)| H20.30.002(0.023)| H18.30.001(0.0)| H19.30.004(0.0)	Balanced	Balanced	2012_B05 (0.2644)|2016_A03 (0.2184)|1482_A03 (0.1724)|2013_B01 (0.1494)|2012_A05 (0.1379)|960_B03 (0.0230)|2013_A01 (0.0115)|1169_A01 (0.0115)|988_C05 (0.0115)	0.2644	2012_B05 (0.2644)|a total of 6229 cells in this dominant library	GPi(0.8046)| GPe(0.1494)| GPeR(0.023)| CaT(0.0115)| STH(0.0115)| CaH(0.0)| CaB(0.0)| GPeC(0.0)| NAC(0.0)| PuC(0.0)| Pu(0.0)| PuPV(0.0)| PuR(0.0)| SN(0.0)| SN-VTA(0.0)	Balanced	0	0.5	0	0.5	0.5	0.16	0.0679	8963	66162	7.38
AIT117_48	IN_48		AIT117_323	NDB SI LHX6 LHX8 GBX1	cluster							70	2	['AL591463.1', 'ELFN1']	['LHX8', 'AL591463.1', 'CCDC178', 'ELFN1', 'GABRA6', 'AL356124.1', 'SOX6', 'AC008415.1', 'CPNE4', 'INSYN2A']	H20.30.001(0.5286)| H23.30.001(0.4714)| H18.30.001(0.0)| H19.30.004(0.0)| H20.30.002(0.0)	Balanced	Balanced	994_C03 (0.4143)|2012_B05 (0.2143)|2012_A05 (0.1000)|960_B03 (0.0714)|2006_B05 (0.0571)|2016_A03 (0.0571)|1482_A03 (0.0429)|2013_B01 (0.0286)|2013_A01 (0.0143)	0.4143	994_C03 (0.4143)|a total of 4714 cells in this dominant library	GPi(0.7571)| GPe(0.1714)| GPeR(0.0714)| CaT(0.0)| CaH(0.0)| CaB(0.0)| GPeC(0.0)| NAC(0.0)| Pu(0.0)| PuC(0.0)| PuPV(0.0)| PuR(0.0)| SN(0.0)| SN-VTA(0.0)| STH(0.0)	Balanced	0	0	0	0	0	0.1	0.0466	4075.5	10266	2.52
AIT117_49	IN_49		AIT117_323	NDB SI LHX6 LHX8 GBX1	cluster							305	3	['AC068787.2', 'GBX1', 'FGF10-AS1']	['AC068787.2', 'AC060765.1', 'FGF10', 'GBX1', 'FGF10-AS1', 'CCDC178', 'EBF4', 'RCBTB1', 'DIPK2A', 'TMEM132C']	H23.30.001(0.8459)| H20.30.001(0.1475)| H20.30.002(0.0066)| H18.30.001(0.0)| H19.30.004(0.0)	Balanced	Balanced	2006_B05 (0.4426)|2012_A05 (0.2656)|960_B03 (0.1311)|2013_A01 (0.0787)|2018_C01 (0.0328)	0.4426	2006_B05 (0.4426)|a total of 6534 cells in this dominant library	GPe(0.8197)| GPeR(0.1311)| GPi(0.0295)| NAC(0.0098)| PuPV(0.0066)| CaB(0.0033)| CaH(0.0)| GPeC(0.0)| CaT(0.0)| Pu(0.0)| PuC(0.0)| PuR(0.0)| SN(0.0)| SN-VTA(0.0)| STH(0.0)	Balanced	0	0	0	0	0	0.1053	0.0644	9039	56359	6.24
AIT117_50	IN_50		AIT117_323	NDB SI LHX6 LHX8 GBX1	cluster							549	3	['ST18', 'MEGF10', 'RMST']	['RNF220', 'ST18', 'PLP1', 'SLC1A3', 'MEGF10', 'RMST', 'AL356124.1', 'ARHGAP18', 'SOX6', 'ADARB2']	H20.30.001(0.5738)| H23.30.001(0.4226)| H20.30.002(0.0036)| H18.30.001(0.0)| H19.30.004(0.0)	Balanced	Balanced	994_C03 (0.5228)|2016_A03 (0.2914)|2018_D01 (0.0692)|960_B03 (0.0401)|2012_A05 (0.0219)|2018_C01 (0.0146)|2006_B05 (0.0128)	0.5228	994_C03 (0.5228)|a total of 4714 cells in this dominant library	GPi(0.8944)| GPe(0.051)| GPeR(0.0401)| PuPV(0.0109)| NAC(0.0036)| CaT(0.0)| CaH(0.0)| GPeC(0.0)| CaB(0.0)| Pu(0.0)| PuC(0.0)| PuR(0.0)| SN(0.0)| SN-VTA(0.0)| STH(0.0)	Balanced	0	0	0	0	0	0.18	0.106	2417	4355	1.8
AIT117_51	IN_51		AIT117_324	SN TH Dopa	cluster							172	2	['LINC01956', 'NPSR1']	['AC078923.1', 'AC074099.1', 'LINC01956', 'NPSR1', 'LINC00261', 'EBF2', 'TH', 'LINC01876', 'EBF3', 'LMX1A']	H20.30.002(0.7442)| H19.30.004(0.2151)| H20.30.001(0.0233)| H23.30.001(0.0174)| H18.30.001(0.0)	Balanced	Balanced	1169_A01 (0.6395)|1468_A09 (0.2151)|1458_A09 (0.1047)|1001_A06 (0.0233)|2058_B03 (0.0174)	0.6395	1169_A01 (0.6395)|a total of 7392 cells in this dominant library	STH(0.9767)| SN-VTA(0.0233)| CaB(0.0)| GPe(0.0)| GPeC(0.0)| CaH(0.0)| CaT(0.0)| GPi(0.0)| GPeR(0.0)| NAC(0.0)| Pu(0.0)| PuPV(0.0)| PuC(0.0)| SN(0.0)| PuR(0.0)	Cautious	0	0	0	0	0	0.11	0.2113	5635	18571	3.3
AIT117_52	IN_52		AIT117_324	SN TH Dopa	cluster							116	2	['SLC6A3', 'SLC18A2']	['SLC6A3', 'SLC18A1', 'CHRNB3', 'LINC01956', 'SLC18A2', 'LINC00261', 'SCUBE1', 'TH', 'EBF3', 'VWA5B1']	H20.30.002(0.6983)| H20.30.001(0.1638)| H19.30.004(0.1034)| H18.30.001(0.0259)| H23.30.001(0.0086)	Balanced	Balanced	1169_A01 (0.6810)|1001_A06 (0.1466)|1468_A09 (0.1034)|925_F03 (0.0259)|1233_A02 (0.0172)|1458_A09 (0.0172)	0.681	1169_A01 (0.681)|a total of 7392 cells in this dominant library	STH(0.8017)| SN-VTA(0.1466)| SN(0.0517)| GPe(0.0)| CaB(0.0)| CaH(0.0)| CaT(0.0)| GPi(0.0)| GPeR(0.0)| GPeC(0.0)| NAC(0.0)| PuPV(0.0)| PuC(0.0)| Pu(0.0)| PuR(0.0)	Balanced	0	0	0	0	0	0.14	0.2205	6379	27032.5	4.24
AIT117_54	IN_54		AIT117_325	GPi Shell	cluster							119	2	['LINC02359', 'LINC01798']	['LINC02359', 'LINC01799', 'LINC01828', 'HPGD', 'LINC01798', 'PAX6', 'FAM163A', 'TBR1', 'PTPN14', 'COL24A1']	H23.30.001(0.6807)| H20.30.001(0.3193)| H18.30.001(0.0)| H19.30.004(0.0)| H20.30.002(0.0)	Balanced	Balanced	2012_A05 (0.2689)|2013_B01 (0.2269)|960_B03 (0.1933)|2016_A03 (0.1513)|994_C03 (0.1176)|2012_B05 (0.0252)	0.2689	2012_A05 (0.2689)|a total of 7367 cells in this dominant library	GPi(0.5294)| GPe(0.2773)| GPeR(0.1933)| CaT(0.0)| CaH(0.0)| CaB(0.0)| GPeC(0.0)| NAC(0.0)| Pu(0.0)| PuC(0.0)| PuPV(0.0)| PuR(0.0)| SN(0.0)| SN-VTA(0.0)| STH(0.0)	Balanced	0	0	0	0	0	0.1471	0.0752	6739	25602	3.8
AIT117_55	IN_55		AIT117_326	BN LAMP5 CXCL14 GABA	cluster							496	3	['ROR2', 'CRH', 'EYA4']	['ROR2', 'CRH', 'AC132803.1', 'EYA4', 'KIT', 'NRIP3', 'EPHA3', 'NTNG1', 'UNC13C', 'FBXL7']	H23.30.001(0.3629)| H18.30.001(0.3185)| H20.30.002(0.1613)| H20.30.001(0.1573)| H19.30.004(0.0)	Balanced	Balanced	988_D05 (0.1270)|988_C05 (0.0585)|1955_C06 (0.0544)|988_E05 (0.0524)|847_D04 (0.0484)|2016_C03 (0.0363)|2018_E01 (0.0343)|847_C04 (0.0343)|2018_C01 (0.0343)|1110_A07 (0.0242)|2018_A01 (0.0222)|2016_B03 (0.0222)|980_C02 (0.0222)|960_B03 (0.0222)|822_B01 (0.0202)|930_B05 (0.0202)|1959_A02 (0.0202)|2013_C01 (0.0181)|1110_B07 (0.0181)|847_A04 (0.0181)|2018_B01 (0.0141)|822_A01 (0.0141)|1482_A03 (0.0141)|897_E03 (0.0141)|930_D05 (0.0141)|1959_C02 (0.0141)|925_F03 (0.0121)|2006_A05 (0.0121)|1091_A05 (0.0121)|930_C05 (0.0121)|2012_A05 (0.0121)|1169_A01 (0.0101)|2013_B01 (0.0101)|2012_B05 (0.0101)|1036_C03 (0.0101)|1959_B02 (0.0101)|2013_A01 (0.0101)	0.127	988_D05 (0.127)|a total of 8686 cells in this dominant library	CaT(0.25)| PuPV(0.1573)| PuC(0.127)| NAC(0.1008)| Pu(0.0685)| GPe(0.0625)| CaB(0.0585)| GPi(0.0484)| CaH(0.0444)| PuR(0.0242)| GPeR(0.0222)| STH(0.0161)| SN(0.0141)| GPeC(0.006)| SN-VTA(0.0)	Balanced	0	0	0	0	0	0.03	0.2501	5807	22217.5	3.83
AIT117_56	IN_56		AIT117_326	BN LAMP5 CXCL14 GABA	cluster							543	2	['AC132803.1', 'POU6F2']	['AC092819.3', 'LINC00298', 'AC132803.1', 'ADAMTS20', 'MPPED1', 'POU6F2', 'PRELID2', 'KIT', 'FREM1', 'KCNH5']	H23.30.001(0.4751)| H20.30.001(0.2007)| H18.30.001(0.186)| H20.30.002(0.1363)| H19.30.004(0.0018)	Balanced	Balanced	1482_A03 (0.1308)|2012_B05 (0.0976)|988_C05 (0.0810)|2018_C01 (0.0810)|988_D05 (0.0718)|2016_C03 (0.0479)|2018_E01 (0.0460)|925_F03 (0.0424)|2016_A03 (0.0387)|1955_C06 (0.0276)|988_E05 (0.0276)|847_C04 (0.0258)|2013_B01 (0.0239)|930_B05 (0.0239)|980_C02 (0.0221)|2018_B01 (0.0203)|847_A04 (0.0184)|822_B01 (0.0184)|2012_A05 (0.0147)|2058_C03 (0.0129)|2012_C05 (0.0129)|2018_A01 (0.0110)	0.1308	1482_A03 (0.1308)|a total of 4968 cells in this dominant library	GPi(0.3039)| CaT(0.2339)| PuPV(0.14)| GPe(0.1013)| SN(0.0552)| PuC(0.0405)| CaH(0.0295)| Pu(0.0295)| NAC(0.0239)| STH(0.0147)| CaB(0.0129)| GPeR(0.0055)| GPeC(0.0037)| PuR(0.0037)| SN-VTA(0.0018)	Balanced	0	0	0	0	0	0.0476	0.1325	5352	19827	3.7
AIT117_57	IN_57		AIT117_326	BN LAMP5 CXCL14 GABA	cluster							198	3	['AC132803.1', 'LAMA3', 'HPSE2']	['LINC00298', 'AC132803.1', 'LYPD6', 'MPPED1', 'LAMA3', 'HPSE2', 'TCERG1L', 'ADAMTS9-AS2', 'TACR1', 'SDK2']	H20.30.001(0.5354)| H20.30.002(0.3333)| H23.30.001(0.0859)| H18.30.001(0.0455)| H19.30.004(0.0)	Balanced	Balanced	1482_A03 (0.5101)|988_C05 (0.3182)|2012_B05 (0.0404)|925_F03 (0.0404)|2016_A03 (0.0202)|930_B05 (0.0152)|2016_C03 (0.0152)|960_B03 (0.0101)|988_E05 (0.0101)	0.5101	1482_A03 (0.5101)|a total of 4968 cells in this dominant library	GPi(0.5707)| CaT(0.3182)| SN(0.0404)| PuPV(0.0303)| PuC(0.0152)| GPeR(0.0101)| GPe(0.0101)| NAC(0.0051)| GPeC(0.0)| CaB(0.0)| CaH(0.0)| Pu(0.0)| PuR(0.0)| SN-VTA(0.0)| STH(0.0)	Balanced	0	0	0	0	0	0.0429	0.6281	4050	12656	3.12
AIT117_58	IN_58		AIT117_326	BN LAMP5 CXCL14 GABA	cluster							573	2	['NDNF', 'AC092819.3']	['NDNF', 'AC005064.1', 'AC092819.3', 'PAPSS2', 'LINC00298', 'SGO1-AS1', 'MPPED1', 'AC007368.1', 'FREM1', 'TOX3']	H23.30.001(0.3246)| H18.30.001(0.3194)| H20.30.002(0.1798)| H20.30.001(0.1693)| H19.30.004(0.007)	Balanced	Balanced	925_F03 (0.2478)|988_C05 (0.1291)|1482_A03 (0.1030)|2012_B05 (0.0628)|2016_C03 (0.0384)|2018_C01 (0.0366)|1955_C06 (0.0314)|822_B01 (0.0209)|988_D05 (0.0192)|2018_B01 (0.0192)|2018_E01 (0.0175)|980_C02 (0.0175)|988_E05 (0.0157)|847_C04 (0.0157)|2013_C01 (0.0157)|2012_A05 (0.0140)|847_A04 (0.0140)|2018_A01 (0.0140)|2016_A03 (0.0122)|1955_B06 (0.0122)|2012_C05 (0.0105)|930_B05 (0.0105)|1169_A01 (0.0105)	0.2478	925_F03 (0.2478)|a total of 3479 cells in this dominant library	SN(0.2548)| CaT(0.1937)| GPi(0.1902)| PuPV(0.1099)| GPe(0.0541)| NAC(0.0384)| CaH(0.0349)| Pu(0.0332)| PuC(0.0314)| CaB(0.0262)| STH(0.0192)| GPeR(0.0087)| PuR(0.0035)| GPeC(0.0017)| SN-VTA(0.0)	Balanced	0	0	0	0	0	0.0455	0.2323	5599	21020	3.75
AIT117_59	IN_59		AIT117_327	STR VIP GABA	cluster							117	2	['AC011990.1', 'AC079148.3']	['LINC01931', 'AC011990.1', 'EGF', 'PNOC', 'AC079148.3', 'CHRNA2', 'ABCA9-AS1', 'ADAMTSL1', 'SEMA3C', 'TOX3']	H23.30.001(0.359)| H20.30.002(0.265)| H20.30.001(0.2051)| H18.30.001(0.1709)| H19.30.004(0.0)	Balanced	Balanced	980_C02 (0.0769)|2018_E01 (0.0684)|2018_B01 (0.0598)|988_E05 (0.0598)|988_D05 (0.0513)|930_D05 (0.0513)|822_A01 (0.0513)|822_B01 (0.0513)|988_C05 (0.0513)|2018_C01 (0.0427)|847_A04 (0.0427)|2006_A05 (0.0342)|847_D04 (0.0342)|2013_C01 (0.0342)|897_E03 (0.0342)|930_B05 (0.0342)|2012_C05 (0.0256)|1959_B02 (0.0171)|2018_A01 (0.0171)|1110_A07 (0.0171)|847_C04 (0.0171)|1042_A06 (0.0171)|1959_C02 (0.0171)	0.0769	980_C02 (0.0769)|a total of 6906 cells in this dominant library	CaT(0.2735)| PuPV(0.1966)| PuC(0.1453)| CaB(0.1197)| CaH(0.0684)| GPe(0.0513)| PuR(0.0513)| NAC(0.0427)| Pu(0.0256)| STH(0.0171)| GPi(0.0085)| GPeR(0.0)| GPeC(0.0)| SN(0.0)| SN-VTA(0.0)	Balanced	0	0	0	0	0	0.04	0.138	5843	21440	3.67
AIT117_60	IN_60		AIT117_327	STR VIP GABA	cluster							159	2	['IL17RD', 'THSD7B']	['IL17RD', 'PCDH18', 'CASC6', 'PTGFR', 'ADAMTSL1', 'THSD7B', 'NAP1L3', 'ARHGAP18', 'AL356124.1', 'SDK1']	H20.30.002(0.2704)| H18.30.001(0.2579)| H20.30.001(0.2516)| H23.30.001(0.2138)| H19.30.004(0.0063)	Balanced	Balanced	925_F03 (0.2201)|988_C05 (0.2013)|1482_A03 (0.1824)|2018_C01 (0.0314)|2012_B05 (0.0314)|1955_C06 (0.0314)|980_C02 (0.0252)|2012_C05 (0.0252)|1955_B06 (0.0252)|1042_A06 (0.0189)|1091_A05 (0.0189)|930_E05 (0.0189)|930_B05 (0.0189)|2018_E01 (0.0189)|930_C05 (0.0126)|2013_B01 (0.0126)|2016_C03 (0.0126)|988_D05 (0.0126)|822_B01 (0.0126)	0.2201	925_F03 (0.2201)|a total of 3479 cells in this dominant library	CaT(0.283)| GPi(0.2327)| SN(0.2201)| NAC(0.0566)| CaH(0.044)| GPe(0.0377)| CaB(0.0314)| Pu(0.0314)| PuC(0.0252)| PuPV(0.0252)| PuR(0.0063)| STH(0.0063)| GPeC(0.0)| GPeR(0.0)| SN-VTA(0.0)	Balanced	0	0	0	0	0	0.0571	0.1925	5878	24388	4.15
AIT117_61	IN_61		AIT117_327	STR VIP GABA	cluster							172	3	['IGFBP5', 'FLT1', 'PTH2R']	['SCTR', 'LINC01931', 'IGFBP5', 'FLT1', 'AL391832.4', 'PTH2R', 'PLCE1', 'VWDE', 'RELN', 'LRFN2']	H23.30.001(0.3663)| H18.30.001(0.2267)| H20.30.002(0.2209)| H20.30.001(0.186)| H19.30.004(0.0)	Balanced	Balanced	822_B01 (0.0756)|2018_E01 (0.0756)|988_C05 (0.0756)|988_D05 (0.0756)|980_C02 (0.0581)|847_A04 (0.0581)|2012_C05 (0.0465)|2018_C01 (0.0407)|988_E05 (0.0407)|2016_C03 (0.0407)|847_C04 (0.0407)|1959_A02 (0.0349)|1955_B06 (0.0291)|1036_B03 (0.0291)|2018_B01 (0.0233)|822_A01 (0.0174)|960_B03 (0.0174)|897_E03 (0.0174)|930_E05 (0.0174)|1036_C03 (0.0116)|2013_B01 (0.0116)|1091_A05 (0.0116)|1042_B06 (0.0116)|1955_C06 (0.0116)|1959_B02 (0.0116)|930_B05 (0.0116)	0.0756	822_B01 (0.0756)|a total of 6920 cells in this dominant library	CaT(0.3314)| PuPV(0.2209)| NAC(0.1163)| CaH(0.1105)| CaB(0.0465)| GPe(0.0465)| PuC(0.0349)| PuR(0.0233)| Pu(0.0174)| GPeR(0.0174)| GPi(0.0174)| SN(0.0116)| GPeC(0.0058)| SN-VTA(0.0)| STH(0.0)	Balanced	0	0	0	0	0	0.0206	0.128	5005	16909	3.38
AIT117_62	IN_62		AIT117_327	STR VIP GABA	cluster							200	3	['SCTR', 'FLT1', 'CHRM2']	['SCTR', 'SHISA8', 'FLT1', 'AL136114.1', 'SYT2', 'CHRM2', 'NCALD', 'CDH13', 'ANK1', 'GRIK1']	H18.30.001(0.28)| H20.30.002(0.265)| H20.30.001(0.255)| H23.30.001(0.2)| H19.30.004(0.0)	Balanced	Balanced	988_D05 (0.1050)|822_B01 (0.0850)|930_D05 (0.0650)|988_E05 (0.0650)|988_C05 (0.0600)|897_E03 (0.0550)|980_C02 (0.0500)|847_C04 (0.0500)|847_D04 (0.0450)|2018_A01 (0.0350)|847_A04 (0.0350)|822_A01 (0.0300)|1955_C06 (0.0300)|930_B05 (0.0250)|930_E05 (0.0250)|1955_B06 (0.0200)|2016_C03 (0.0200)|2018_E01 (0.0150)|930_C05 (0.0150)|930_F05 (0.0150)|2016_B03 (0.0150)|1110_A07 (0.0150)|2018_B01 (0.0150)|847_B04 (0.0150)	0.105	988_D05 (0.105)|a total of 8686 cells in this dominant library	CaT(0.24)| PuPV(0.235)| PuC(0.185)| CaB(0.105)| CaH(0.075)| PuR(0.06)| NAC(0.045)| Pu(0.04)| GPe(0.01)| STH(0.005)| GPeC(0.0)| GPi(0.0)| GPeR(0.0)| SN(0.0)| SN-VTA(0.0)	Balanced	0	0	0	0	0	0.0333	0.3259	5750	19483.5	3.39
AIT117_64	IN_64		AIT117_327	STR VIP GABA	cluster							115	5	['MCUB', 'IQGAP2', 'NTN1', 'LINC02082', 'PLS3']	['MCUB', 'IQGAP2', 'NTN1', 'LINC02082', 'ABI3BP', 'PLS3', 'VWDE', 'SOX1-OT', 'NELL1', 'SDK1']	H23.30.001(0.3652)| H20.30.002(0.3391)| H18.30.001(0.1652)| H20.30.001(0.1304)| H19.30.004(0.0)	Balanced	Balanced	822_A01 (0.1043)|897_E03 (0.0870)|847_A04 (0.0696)|2006_A05 (0.0609)|988_C05 (0.0435)|1955_C06 (0.0435)|2018_E01 (0.0348)|980_C02 (0.0348)|1959_B02 (0.0348)|2018_C01 (0.0348)|1959_C02 (0.0348)|988_D05 (0.0261)|2016_C03 (0.0261)|2012_A05 (0.0261)|2012_C05 (0.0174)|1955_B06 (0.0174)|930_A05 (0.0174)|847_C04 (0.0174)|1042_A06 (0.0174)|1482_A03 (0.0174)|930_B05 (0.0174)|930_C05 (0.0174)|930_D05 (0.0174)|1036_C03 (0.0174)|988_E05 (0.0174)|1110_B07 (0.0174)	0.1043	822_A01 (0.1043)|a total of 10559 cells in this dominant library	CaB(0.1652)| CaH(0.1565)| CaT(0.1565)| PuR(0.1217)| NAC(0.087)| Pu(0.0783)| PuPV(0.0783)| GPe(0.0609)| PuC(0.0435)| GPi(0.0348)| SN(0.0087)| STH(0.0087)| GPeC(0.0)| GPeR(0.0)| SN-VTA(0.0)	Balanced	0	0	0	0	0	0.0217	0.1374	5120	16539	3.23
AIT117_65	IN_65		AIT117_327	STR VIP GABA	cluster							282	3	['VWA5B1', 'VIP', 'CCK']	['VWA5B1', 'VIP', 'AC013265.1', 'PTH2R', 'CCK', 'ABI3BP', 'STK32B', 'THSD7B', 'PCDH19', 'NELL1']	H23.30.001(0.2979)| H20.30.002(0.2695)| H18.30.001(0.2624)| H20.30.001(0.1702)| H19.30.004(0.0)	Balanced	Balanced	988_C05 (0.1560)|1482_A03 (0.1277)|925_F03 (0.1241)|1955_C06 (0.0922)|1091_A05 (0.0461)|988_D05 (0.0390)|2016_C03 (0.0355)|2018_C01 (0.0355)|930_B05 (0.0248)|1042_A06 (0.0213)|1036_A03 (0.0213)|847_A04 (0.0177)|847_C04 (0.0142)|1036_C03 (0.0142)|1036_B03 (0.0142)|1959_B02 (0.0142)|2018_E01 (0.0142)|2013_A01 (0.0142)|2012_B05 (0.0106)|2013_B01 (0.0106)|1959_A02 (0.0106)|1955_B06 (0.0106)|2013_C01 (0.0106)|960_B03 (0.0106)|1110_A07 (0.0106)|1110_B07 (0.0106)|2016_A03 (0.0106)|822_B01 (0.0106)	0.156	988_C05 (0.156)|a total of 5279 cells in this dominant library	CaT(0.2128)| GPi(0.1596)| NAC(0.156)| SN(0.1277)| Pu(0.0957)| PuPV(0.0674)| GPe(0.0603)| CaH(0.0426)| PuC(0.0284)| CaB(0.0248)| GPeR(0.0106)| STH(0.0071)| PuR(0.0071)| GPeC(0.0)| SN-VTA(0.0)	Balanced	0	0	0	0	0	0.0286	0.2259	5799	21910.5	3.78
AIT117_66	IN_66		AIT117_327	STR VIP GABA	cluster							215	3	['VIPR2', 'NPR3', 'PPP1R1C']	['VIPR2', 'AC021594.2', 'AC020930.1', 'NPR3', 'VIP', 'PPP1R1C', 'AC013265.1', 'AL589693.1', 'PLCE1', 'TRPC6']	H20.30.002(0.3256)| H23.30.001(0.2419)| H20.30.001(0.2279)| H18.30.001(0.2047)| H19.30.004(0.0)	Balanced	Balanced	988_C05 (0.1023)|822_B01 (0.0698)|822_A01 (0.0558)|897_E03 (0.0512)|988_D05 (0.0512)|1955_C06 (0.0465)|847_C04 (0.0419)|988_E05 (0.0419)|930_E05 (0.0372)|2016_C03 (0.0372)|980_C02 (0.0326)|925_F03 (0.0279)|1955_B06 (0.0279)|930_C05 (0.0279)|930_B05 (0.0233)|847_D04 (0.0233)|1482_A03 (0.0233)|930_F05 (0.0233)|2018_C01 (0.0186)|847_A04 (0.0186)|2018_A01 (0.0186)|1959_A02 (0.0186)|2013_C01 (0.0140)|2006_A05 (0.0140)|960_B03 (0.0140)|891_A06 (0.0140)|1959_B02 (0.0140)	0.1023	988_C05 (0.1023)|a total of 5279 cells in this dominant library	PuPV(0.1953)| CaT(0.186)| CaB(0.1302)| CaH(0.0977)| PuR(0.0837)| PuC(0.0791)| NAC(0.0698)| Pu(0.0512)| GPi(0.0326)| GPe(0.0279)| SN(0.0279)| GPeR(0.014)| GPeC(0.0047)| SN-VTA(0.0)| STH(0.0)	Balanced	0	0	0	0	0	0.027	0.2706	5435	18279	3.36
AIT117_67	IN_67		AIT117_327	STR VIP GABA	cluster							424	3	['SHISA8', 'VIP', 'AC013265.1']	['CHRNA2', 'SHISA8', 'CCNG2', 'VIP', 'AC013265.1', 'PTHLH', 'COL12A1', 'IQGAP2', 'ABI3BP', 'PROS1']	H20.30.002(0.2877)| H20.30.001(0.2689)| H23.30.001(0.2571)| H18.30.001(0.1863)| H19.30.004(0.0)	Balanced	Balanced	822_B01 (0.0920)|897_E03 (0.0778)|930_C05 (0.0778)|980_C02 (0.0637)|847_A04 (0.0590)|930_E05 (0.0495)|988_C05 (0.0401)|988_D05 (0.0401)|847_C04 (0.0377)|988_E05 (0.0330)|2006_A05 (0.0330)|822_A01 (0.0307)|1959_B02 (0.0283)|1955_B06 (0.0259)|2018_A01 (0.0236)|1955_C06 (0.0236)|2018_E01 (0.0212)|2012_C05 (0.0189)|891_A06 (0.0189)|2018_B01 (0.0165)|2013_C01 (0.0165)|1036_A03 (0.0165)|930_F05 (0.0165)|930_B05 (0.0142)|1036_B03 (0.0142)|2012_A05 (0.0118)	0.092	822_B01 (0.092)|a total of 6920 cells in this dominant library	CaH(0.1981)| CaB(0.1958)| PuPV(0.1863)| CaT(0.184)| NAC(0.059)| PuC(0.0519)| PuR(0.0495)| Pu(0.0283)| GPe(0.0236)| GPi(0.0142)| GPeR(0.0047)| STH(0.0024)| SN(0.0024)| GPeC(0.0)| SN-VTA(0.0)	Balanced	0	0	0	0	0	0.0267	0.1809	5151	15942.5	3.1
AIT117_68	IN_68		AIT117_327	STR VIP GABA	cluster							215	3	['VIP', 'SERTM1', 'CMTM8']	['EREG', 'VIP', 'SERTM1', 'ANGPT1', 'LINC01470', 'CMTM8', 'PLS3', 'SLITRK4', 'SVIL', 'ARHGEF28']	H23.30.001(0.3023)| H20.30.002(0.2465)| H18.30.001(0.2372)| H20.30.001(0.214)| H19.30.004(0.0)	Balanced	Balanced	988_C05 (0.1581)|1482_A03 (0.1070)|925_F03 (0.0791)|988_D05 (0.0651)|2012_B05 (0.0605)|2018_C01 (0.0419)|2016_C03 (0.0419)|2016_A03 (0.0326)|980_C02 (0.0279)|822_B01 (0.0279)|2013_B01 (0.0233)|1955_C06 (0.0233)|847_C04 (0.0233)|1110_A07 (0.0233)|960_B03 (0.0233)|822_A01 (0.0186)|847_D04 (0.0186)|2012_A05 (0.0140)|2058_C03 (0.0140)|1036_A03 (0.0140)|1091_A05 (0.0140)|1042_C06 (0.0140)	0.1581	988_C05 (0.1581)|a total of 5279 cells in this dominant library	CaT(0.2605)| GPi(0.2419)| NAC(0.107)| PuPV(0.093)| SN(0.093)| GPe(0.0698)| PuC(0.0419)| Pu(0.0233)| PuR(0.0233)| GPeR(0.0233)| CaB(0.014)| STH(0.0047)| GPeC(0.0047)| CaH(0.0)| SN-VTA(0.0)	Balanced	0	0	0	0	0	0.0323	0.3106	5179	18426	3.56
AIT117_69	IN_69		AIT117_327	STR VIP GABA	cluster							120	3	['ITGA8', 'LYPD6', 'CMTM8']	['RGS5', 'TAC3', 'ITGA8', 'LYPD6', 'IQGAP2', 'CMTM8', 'CXCL14', 'AC007368.1', 'NRP1', 'TOX2']	H20.30.002(0.3)| H23.30.001(0.2583)| H18.30.001(0.2417)| H20.30.001(0.2)| H19.30.004(0.0)	Balanced	Balanced	988_C05 (0.1000)|1482_A03 (0.0917)|925_F03 (0.0917)|988_D05 (0.0750)|822_A01 (0.0667)|988_E05 (0.0500)|847_C04 (0.0500)|2018_C01 (0.0417)|822_B01 (0.0417)|1955_C06 (0.0417)|930_B05 (0.0333)|2012_A05 (0.0333)|1036_A03 (0.0333)|960_B03 (0.0333)|2016_C03 (0.0250)|2013_B01 (0.0167)|980_C02 (0.0167)|2013_C01 (0.0167)|847_A04 (0.0167)	0.1	988_C05 (0.1)|a total of 5279 cells in this dominant library	CaT(0.2083)| PuPV(0.175)| GPi(0.125)| SN(0.0917)| GPe(0.075)| PuR(0.0667)| NAC(0.0583)| PuC(0.0583)| Pu(0.0417)| CaH(0.0333)| GPeR(0.0333)| CaB(0.025)| STH(0.0083)| GPeC(0.0)| SN-VTA(0.0)	Balanced	0	0	0	0	0	0.0235	0.3241	4863.5	15640	3.22
AIT117_70	IN_70		AIT117_327	STR VIP GABA	cluster							213	4	['CASC6', 'NPR3', 'AL391832.4', 'PTH2R']	['CASC6', 'NPR3', 'AL391832.4', 'AC013265.1', 'ADRA1B', 'PTH2R', 'AL136114.1', 'STK32B', 'CALB2', 'PROX1']	H18.30.001(0.3239)| H20.30.002(0.3146)| H20.30.001(0.2535)| H23.30.001(0.108)| H19.30.004(0.0)	Balanced	Balanced	925_F03 (0.2958)|988_C05 (0.2911)|1482_A03 (0.2254)|1955_C06 (0.0235)|2012_B05 (0.0188)|2016_A03 (0.0188)|988_D05 (0.0141)|822_A01 (0.0141)	0.2958	925_F03 (0.2958)|a total of 3479 cells in this dominant library	CaT(0.3146)| SN(0.3052)| GPi(0.2629)| Pu(0.0282)| PuPV(0.0282)| NAC(0.0141)| PuR(0.0141)| GPeR(0.0094)| GPe(0.0047)| CaB(0.0047)| CaH(0.0047)| STH(0.0047)| PuC(0.0047)| GPeC(0.0)| SN-VTA(0.0)	Balanced	0	0	0	0	0	0.0286	0.4255	5850	22597	3.86
AIT117_71	IN_71		AIT117_327	STR VIP GABA	cluster							246	3	['AJ006995.1', 'LINC01630', 'NXPH2']	['AC011990.1', 'AJ006995.1', 'CHRNA2', 'KMO', 'LINC01630', 'NXPH2', 'MIR4300HG', 'MEGF11', 'COL19A1', 'SDK1']	H20.30.001(0.3008)| H20.30.002(0.2805)| H23.30.001(0.2398)| H18.30.001(0.1789)| H19.30.004(0.0)	Balanced	Balanced	822_B01 (0.0935)|988_E05 (0.0935)|988_C05 (0.0691)|980_C02 (0.0610)|930_F05 (0.0569)|822_A01 (0.0528)|988_D05 (0.0488)|847_C04 (0.0447)|2018_B01 (0.0407)|930_E05 (0.0366)|847_D04 (0.0366)|2018_A01 (0.0325)|1955_C06 (0.0285)|897_E03 (0.0285)|930_D05 (0.0285)|847_A04 (0.0244)|2018_E01 (0.0244)|930_B05 (0.0244)|2016_B03 (0.0203)|2016_C03 (0.0203)|930_C05 (0.0163)|2006_A05 (0.0163)|2013_C01 (0.0122)	0.0935	822_B01 (0.0935)|a total of 6920 cells in this dominant library	PuPV(0.2927)| CaT(0.2073)| PuC(0.1423)| PuR(0.1138)| CaB(0.1016)| CaH(0.0569)| Pu(0.0366)| NAC(0.0163)| GPe(0.0122)| GPeR(0.0081)| GPi(0.0041)| STH(0.0041)| SN(0.0041)| GPeC(0.0)| SN-VTA(0.0)	Balanced	0	0	0	0	0	0.02	0.3489	5190.5	17700	3.41
AIT117_72	IN_72		AIT117_328	GPi Core	cluster							153	4	['ONECUT1', 'PVALB', 'TAFA4', 'AC068051.1']	['LINC02008', 'ONECUT1', 'PVALB', 'LHX1', 'TAFA4', 'AC068051.1', 'SPHKAP', 'NEFL', 'CNTN6', 'SPARCL1']	H23.30.001(0.8954)| H20.30.001(0.0784)| H20.30.002(0.0261)| H18.30.001(0.0)| H19.30.004(0.0)	Balanced	Balanced	2012_B05 (0.7647)|2012_A05 (0.0980)|960_B03 (0.0392)|2016_A03 (0.0261)|994_C03 (0.0196)|1482_A03 (0.0196)|1169_A01 (0.0131)	0.7647	2012_B05 (0.7647)|a total of 6229 cells in this dominant library	GPi(0.8366)| GPe(0.098)| GPeR(0.0392)| STH(0.0261)| CaT(0.0)| CaB(0.0)| CaH(0.0)| GPeC(0.0)| NAC(0.0)| PuC(0.0)| Pu(0.0)| PuPV(0.0)| PuR(0.0)| SN(0.0)| SN-VTA(0.0)	Balanced	0	0	0	0	0	0.087	0.0746	10250	78947	7.7
AIT117_73	IN_73		AIT117_328	GPi Core	cluster							249	4	['LINC02520', 'ONECUT1', 'LHX1', 'MIR34AHG']	['LINC02520', 'ONECUT1', 'LHX1', 'LHX1-DT', 'TAFA4', 'MIR34AHG', 'SPHKAP', 'ABHD12B', 'GFRA1', 'PLCH1']	H23.30.001(0.9398)| H20.30.001(0.0442)| H20.30.002(0.0161)| H18.30.001(0.0)| H19.30.004(0.0)	Cautious	Balanced	2016_A03 (0.6546)|2013_B01 (0.1285)|2012_B05 (0.1165)|960_B03 (0.0321)|2012_A05 (0.0281)|1169_A01 (0.0161)	0.6546	2016_A03 (0.6546)|a total of 8401 cells in this dominant library	GPi(0.9116)| GPeR(0.0321)| GPe(0.0281)| STH(0.0241)| SN(0.004)| CaT(0.0)| CaH(0.0)| GPeC(0.0)| CaB(0.0)| NAC(0.0)| Pu(0.0)| PuPV(0.0)| PuC(0.0)| PuR(0.0)| SN-VTA(0.0)	Balanced	0	0	0	0	0	0.0879	0.0372	9065	66764	7.37
AIT117_74	IN_74		AIT117_329	BG SKOR1 Glut	cluster							187	3	['KCNJ5', 'EMX2OS', 'TBR1']	['KCNJ5', 'AC117453.1', 'EMX2OS', 'RSPO3', 'TBR1', 'AC022523.1', 'LEF1', 'AL136114.1', 'MIR646HG', 'CA10']	H23.30.001(0.6791)| H20.30.001(0.2834)| H18.30.001(0.0214)| H20.30.002(0.016)| H19.30.004(0.0)	Balanced	Balanced	2013_B01 (0.3957)|1482_A03 (0.2620)|2012_B05 (0.1765)|2016_A03 (0.0909)|960_B03 (0.0160)|925_F03 (0.0160)|988_C05 (0.0107)	0.3957	2013_B01 (0.3957)|a total of 4881 cells in this dominant library	GPi(0.9251)| SN(0.0214)| GPeR(0.016)| GPe(0.0107)| CaT(0.0107)| NAC(0.0053)| CaB(0.0053)| STH(0.0053)| CaH(0.0)| GPeC(0.0)| Pu(0.0)| PuPV(0.0)| PuC(0.0)| PuR(0.0)| SN-VTA(0.0)	Balanced	0	0	0	0	0	0.1	0.0696	8019	46734	5.83
AIT117_75	IN_75		AIT117_329	BG SKOR1 Glut	cluster							167	4	['KCNJ5', 'ADCYAP1', 'LHX5-AS1', 'TBR1']	['KCNJ5', 'ADCYAP1', 'LHX5-AS1', 'AC117453.1', 'RSPO3', 'TBR1', 'PGM5', 'SLC17A6', 'ADAMTSL1', 'EPHA3']	H23.30.001(0.7665)| H20.30.001(0.2216)| H18.30.001(0.012)| H19.30.004(0.0)| H20.30.002(0.0)	Balanced	Balanced	2013_B01 (0.5090)|1482_A03 (0.0958)|960_B03 (0.0838)|2016_A03 (0.0719)|2012_B05 (0.0539)|2012_A05 (0.0479)|2018_C01 (0.0299)|2006_B05 (0.0240)|994_C03 (0.0240)|2013_A01 (0.0180)|1110_A07 (0.0120)|1042_C06 (0.0120)	0.509	2013_B01 (0.509)|a total of 4881 cells in this dominant library	GPi(0.7545)| GPe(0.1198)| GPeR(0.0838)| NAC(0.024)| SN(0.006)| PuPV(0.006)| STH(0.006)| GPeC(0.0)| CaB(0.0)| CaH(0.0)| CaT(0.0)| PuC(0.0)| Pu(0.0)| PuR(0.0)| SN-VTA(0.0)	Balanced	0	0	0	0	0	0.1176	0.0722	8802	59587	6.77
AIT117_76	IN_76		AIT117_329	BG SKOR1 Glut	cluster							181	4	['PTGER3', 'LHX5-AS1', 'TBR1', 'STK32A']	['PTGER3', 'LHX5-AS1', 'AC117453.1', 'TBR1', 'SLC17A6', 'STK32A', 'TRPC3', 'SAMD3', 'PLPP4', 'GABRG1']	H23.30.001(0.9669)| H20.30.001(0.0276)| H20.30.002(0.0055)| H18.30.001(0.0)| H19.30.004(0.0)	Cautious	Balanced	2013_B01 (0.9006)|2016_A03 (0.0442)|960_B03 (0.0221)|2058_C03 (0.0110)	0.9006	2013_B01 (0.9006)|a total of 4881 cells in this dominant library	GPi(0.9558)| GPeR(0.0221)| SN(0.011)| STH(0.0055)| GPe(0.0055)| CaT(0.0)| CaH(0.0)| GPeC(0.0)| CaB(0.0)| NAC(0.0)| Pu(0.0)| PuPV(0.0)| PuC(0.0)| PuR(0.0)| SN-VTA(0.0)	Cautious	0	0.95	0	0.63	0.63	0.1029	0.0419	8661	57116	6.59
AIT117_77	IN_77		AIT117_329	BG SKOR1 Glut	cluster							101	3	['AC117453.1', 'LEF1', 'SULF1']	['AC110992.1', 'AC117453.1', 'RSPO3', 'SEMA3D', 'LEF1', 'SULF1', 'ROR1', 'MEGF11', 'NDST4', 'NOS1']	H23.30.001(0.9406)| H20.30.001(0.0495)| H20.30.002(0.0099)| H18.30.001(0.0)| H19.30.004(0.0)	Cautious	Balanced	2013_B01 (0.7822)|2012_B05 (0.0891)|1482_A03 (0.0495)|2016_A03 (0.0495)	0.7822	2013_B01 (0.7822)|a total of 4881 cells in this dominant library	GPi(0.9703)| CaT(0.0099)| CaB(0.0099)| SN(0.0099)| CaH(0.0)| GPeC(0.0)| GPe(0.0)| GPeR(0.0)| NAC(0.0)| PuC(0.0)| Pu(0.0)| PuPV(0.0)| PuR(0.0)| SN-VTA(0.0)| STH(0.0)	Cautious	0	0	0	0	0	0.1209	0.051	8465	53216	6.29
AIT117_78	IN_78		AIT117_329	BG SKOR1 Glut	cluster							114	3	['ADAM2', 'FAM9B', 'CYP1B1-AS1']	['FST', 'ADAM2', 'ISM1', 'FAM9B', 'RSPO3', 'CYP1B1-AS1', 'AP000829.1', 'ADAMTSL1', 'SEMA3C', 'TRHDE']	H23.30.001(0.9123)| H20.30.001(0.0877)| H18.30.001(0.0)| H19.30.004(0.0)| H20.30.002(0.0)	Cautious	Balanced	2012_B05 (0.3947)|2012_A05 (0.1491)|2016_A03 (0.1316)|2018_D01 (0.0877)|2013_B01 (0.0702)|960_B03 (0.0526)|1482_A03 (0.0351)|2018_C01 (0.0351)|2058_C03 (0.0175)|2013_A01 (0.0175)	0.3947	2012_B05 (0.3947)|a total of 6229 cells in this dominant library	GPi(0.7193)| GPe(0.2105)| GPeR(0.0526)| SN(0.0175)| CaT(0.0)| CaB(0.0)| CaH(0.0)| GPeC(0.0)| NAC(0.0)| PuC(0.0)| Pu(0.0)| PuPV(0.0)| PuR(0.0)| SN-VTA(0.0)| STH(0.0)	Balanced	0	0	0	0	0	0.15	0.0684	7640.5	38593.5	5.05
AIT117_79	IN_79		AIT117_321	STR FS PTHLH ST18 GABA	cluster							1012	4	['KLB', 'AP002989.1', 'PPP1R1C', 'PDGFD']	['KLB', 'AP002989.1', 'PPP1R1C', 'AC067956.1', 'PDGFD', 'AC019211.1', 'ROR1', 'IL1RAPL2', 'MIR34AHG', 'COL19A1']	H23.30.001(0.4496)| H18.30.001(0.2115)| H20.30.002(0.1769)| H20.30.001(0.1621)| H19.30.004(0.0)	Balanced	Balanced	847_A04 (0.0830)|2016_C03 (0.0731)|988_D05 (0.0721)|2006_A05 (0.0563)|930_E05 (0.0494)|822_B01 (0.0445)|2018_B01 (0.0435)|2018_A01 (0.0395)|897_E03 (0.0385)|2006_B05 (0.0366)|822_A01 (0.0356)|930_C05 (0.0306)|1955_B06 (0.0306)|2016_B03 (0.0306)|980_C02 (0.0277)|2018_E01 (0.0277)|988_E05 (0.0247)|988_C05 (0.0198)|2013_C01 (0.0188)|1959_C02 (0.0188)|930_B05 (0.0188)|1959_B02 (0.0168)|1955_C06 (0.0158)|2018_C01 (0.0158)|891_A06 (0.0148)|847_B04 (0.0109)|847_C04 (0.0109)|2013_A01 (0.0109)	0.083	847_A04 (0.083)|a total of 9215 cells in this dominant library	PuPV(0.1966)| CaB(0.1779)| CaH(0.167)| CaT(0.1512)| PuC(0.1047)| GPe(0.0672)| PuR(0.0534)| NAC(0.0405)| Pu(0.0346)| STH(0.0049)| GPeC(0.001)| GPeR(0.001)| GPi(0.0)| SN(0.0)| SN-VTA(0.0)	Balanced	0	0	0	0	0	0.06	0.1102	7585	35876.5	4.73
AIT117_80	IN_80		AIT117_321	STR FS PTHLH ST18 GABA	cluster							107	2	['MYRFL', 'CCBE1']	['ADGRG6', 'CYP1B1-AS1', 'SFRP1', 'MYRFL', 'CCBE1', 'NDST4', 'SNTG2', 'LTBP1', 'NXPH1', 'VWC2']	H20.30.002(0.3832)| H18.30.001(0.2523)| H20.30.001(0.243)| H23.30.001(0.1215)| H19.30.004(0.0)	Balanced	Balanced	988_C05 (0.1308)|1042_A06 (0.1215)|1482_A03 (0.1028)|1036_C03 (0.0841)|925_F03 (0.0748)|1042_B06 (0.0561)|1110_B07 (0.0561)|1042_C06 (0.0467)|1091_A05 (0.0374)|2016_A03 (0.0374)|2012_A05 (0.0280)|847_A04 (0.0280)|1110_A07 (0.0280)|988_D05 (0.0187)|1036_A03 (0.0187)|1955_C06 (0.0187)|1036_B03 (0.0187)	0.1308	988_C05 (0.1308)|a total of 5279 cells in this dominant library	NAC(0.4766)| GPi(0.1495)| CaT(0.1495)| SN(0.0748)| GPe(0.0374)| CaH(0.028)| PuC(0.0187)| PuPV(0.0187)| STH(0.0187)| Pu(0.0187)| GPeR(0.0093)| GPeC(0.0)| CaB(0.0)| PuR(0.0)| SN-VTA(0.0)	Balanced	0	0	0	0	0	0.0294	0.3193	5639	21689	3.85
AIT117_81	IN_81		AIT117_321	STR FS PTHLH ST18 GABA	cluster							390	4	['AL450338.2', 'LINC01885', 'OPN3', 'PGM5']	['AL450338.2', 'LINC01885', 'LINC02552', 'OPN3', 'PGM5', 'PDGFD', 'ROR1', 'IL1RAPL2', 'COL19A1', 'NXPH1']	H20.30.002(0.4)| H20.30.001(0.2718)| H23.30.001(0.2077)| H18.30.001(0.1205)| H19.30.004(0.0)	Balanced	Balanced	1036_C03 (0.1744)|1042_A06 (0.1103)|1042_C06 (0.0897)|1042_B06 (0.0846)|1036_B03 (0.0718)|1036_A03 (0.0641)|2018_C01 (0.0385)|2016_C03 (0.0385)|1955_B06 (0.0359)|1110_B07 (0.0359)|1091_A05 (0.0308)|2006_B05 (0.0282)|988_D05 (0.0256)|1959_B02 (0.0231)|1110_A07 (0.0179)|988_C05 (0.0179)|822_B01 (0.0154)|930_B05 (0.0128)|980_C02 (0.0128)	0.1744	1036_C03 (0.1744)|a total of 10219 cells in this dominant library	NAC(0.6846)| GPe(0.0769)| CaH(0.0641)| PuPV(0.0615)| CaT(0.0615)| GPi(0.0179)| PuC(0.0128)| Pu(0.0103)| CaB(0.0077)| SN(0.0026)| GPeC(0.0)| GPeR(0.0)| PuR(0.0)| SN-VTA(0.0)| STH(0.0)	Balanced	0	0	0	0	0	0.0274	0.2906	6249.5	24705.5	3.95
AIT117_82	IN_82		AIT117_321	STR FS PTHLH ST18 GABA	cluster							355	2	['NR5A2', 'AC007614.1']	['NR5A2', 'TACR3', 'MOXD1', 'PDGFD', 'AC007614.1', 'CMTM8', 'CLMP', 'IL1RAPL2', 'LAMA4', 'SNTG2']	H23.30.001(0.3493)| H20.30.002(0.231)| H18.30.001(0.2254)| H20.30.001(0.1944)| H19.30.004(0.0)	Balanced	Balanced	1036_C03 (0.0592)|1042_B06 (0.0535)|1955_B06 (0.0535)|1036_B03 (0.0479)|1110_A07 (0.0451)|1042_C06 (0.0451)|1042_A06 (0.0423)|1110_B07 (0.0423)|1091_A05 (0.0423)|822_A01 (0.0394)|1955_C06 (0.0394)|1959_B02 (0.0394)|847_A04 (0.0394)|2016_C03 (0.0310)|1959_C02 (0.0282)|2006_B05 (0.0254)|1036_A03 (0.0254)|988_C05 (0.0254)|2016_B03 (0.0254)|2018_C01 (0.0225)|2006_A05 (0.0225)|988_D05 (0.0197)|897_E03 (0.0169)|1959_A02 (0.0169)|847_B04 (0.0141)|2018_A01 (0.0141)|2018_B01 (0.0141)|930_E05 (0.0141)|847_C04 (0.0113)|930_C05 (0.0113)	0.0592	1036_C03 (0.0592)|a total of 10219 cells in this dominant library	NAC(0.4197)| CaH(0.1493)| PuPV(0.0704)| CaB(0.0676)| Pu(0.0676)| PuC(0.0592)| GPe(0.0563)| PuR(0.0535)| CaT(0.0535)| GPi(0.0028)| GPeC(0.0)| GPeR(0.0)| SN(0.0)| SN-VTA(0.0)| STH(0.0)	Balanced	0	0	0	0	0	0.0606	0.1397	7490	34308	4.58
AIT117_83	IN_83		AIT117_321	STR FS PTHLH ST18 GABA	cluster							295	2	['METTL11B', 'P4HA3']	['METTL11B', 'LINC01681', 'HTR3A', 'NR5A2', 'P4HA3', 'COL5A2', 'GLP1R', 'MOXD1', 'LAMA2', 'SPHKAP']	H20.30.001(0.2814)| H23.30.001(0.2746)| H20.30.002(0.2441)| H18.30.001(0.2)| H19.30.004(0.0)	Balanced	Balanced	1042_B06 (0.0847)|1036_A03 (0.0814)|1042_A06 (0.0814)|1036_B03 (0.0780)|1955_B06 (0.0644)|1091_A05 (0.0644)|1955_C06 (0.0542)|1042_C06 (0.0475)|847_A04 (0.0441)|930_C05 (0.0373)|1110_A07 (0.0339)|1959_A02 (0.0305)|897_E03 (0.0271)|1036_C03 (0.0271)|930_E05 (0.0237)|2006_A05 (0.0237)|1110_B07 (0.0237)|891_A06 (0.0169)|1959_B02 (0.0169)|2006_B05 (0.0169)|2013_C01 (0.0136)|1959_C02 (0.0136)|930_A05 (0.0102)|822_A01 (0.0102)|2018_B01 (0.0102)	0.0847	1042_B06 (0.0847)|a total of 5839 cells in this dominant library	NAC(0.5525)| CaH(0.1729)| CaB(0.1051)| Pu(0.0678)| PuPV(0.0305)| GPe(0.0237)| CaT(0.0237)| PuR(0.0169)| PuC(0.0068)| GPeC(0.0)| GPeR(0.0)| GPi(0.0)| SN(0.0)| SN-VTA(0.0)| STH(0.0)	Balanced	0	0	0	0	0	0.0588	0.1622	7585	33946	4.48
AIT117_84	IN_84		AIT117_321	STR FS PTHLH ST18 GABA	cluster							1033	4	['TLL2', 'LINC01885', 'IL1RAPL2', 'TOX3']	['TLL2', 'LINC01885', 'OPN3', 'PRSS12', 'IL1RAPL2', 'TOX3', 'GLRA3', 'ADAMTS9-AS2', 'COL19A1', 'NXPH1']	H20.30.001(0.3233)| H20.30.002(0.2914)| H23.30.001(0.2362)| H18.30.001(0.1491)| H19.30.004(0.0)	Balanced	Balanced	1036_A03 (0.1075)|930_E05 (0.0910)|847_A04 (0.0668)|1036_B03 (0.0639)|930_C05 (0.0591)|1042_B06 (0.0591)|897_E03 (0.0542)|2013_C01 (0.0523)|1036_C03 (0.0523)|2006_A05 (0.0513)|1042_A06 (0.0503)|1091_A05 (0.0484)|1955_B06 (0.0368)|1042_C06 (0.0348)|1959_A02 (0.0290)|1959_B02 (0.0223)|1110_B07 (0.0155)|822_A01 (0.0136)|980_C02 (0.0106)|2018_E01 (0.0106)	0.1075	1036_A03 (0.1075)|a total of 10559 cells in this dominant library	NAC(0.4656)| CaB(0.2585)| CaH(0.1946)| CaT(0.0242)| PuR(0.0155)| Pu(0.0136)| GPe(0.0106)| PuPV(0.0106)| PuC(0.0058)| GPi(0.001)| GPeC(0.0)| GPeR(0.0)| SN(0.0)| SN-VTA(0.0)| STH(0.0)	Balanced	0	0	0	0	0	0.02	0.1873	5926	20504	3.46
AIT117_85	IN_85		AIT117_321	STR FS PTHLH ST18 GABA	cluster							1315	3	['AP002989.1', 'PPP1R1C', 'MYRFL']	['KLB', 'AC105411.1', 'AP002989.1', 'PPP1R1C', 'OPN3', 'MYRFL', 'PDGFD', 'AL353784.1', 'PRSS12', 'IL1RAPL2']	H20.30.001(0.2837)| H23.30.001(0.2624)| H18.30.001(0.251)| H20.30.002(0.203)| H19.30.004(0.0)	Balanced	Balanced	847_A04 (0.1209)|930_E05 (0.0996)|980_C02 (0.0890)|897_E03 (0.0806)|2006_A05 (0.0570)|930_C05 (0.0532)|1036_A03 (0.0479)|2013_C01 (0.0357)|822_A01 (0.0357)|891_A06 (0.0350)|1955_B06 (0.0342)|1959_B02 (0.0266)|1110_A07 (0.0236)|1955_C06 (0.0198)|2018_E01 (0.0183)|988_D05 (0.0175)|1036_B03 (0.0175)|1091_A05 (0.0167)|1110_B07 (0.0152)|847_D04 (0.0144)|2018_B01 (0.0137)|1036_C03 (0.0137)|2018_A01 (0.0114)|930_A05 (0.0106)	0.1209	847_A04 (0.1209)|a total of 9215 cells in this dominant library	CaB(0.308)| CaH(0.2456)| NAC(0.1665)| CaT(0.1331)| PuR(0.0395)| PuC(0.035)| PuPV(0.0319)| Pu(0.0297)| GPe(0.0099)| GPeC(0.0008)| GPeR(0.0)| GPi(0.0)| SN(0.0)| SN-VTA(0.0)| STH(0.0)	Balanced	0	0	0	0	0	0.0286	0.133	6598	24572	3.72
AIT117_86	IN_86		AIT117_321	STR FS PTHLH ST18 GABA	cluster							459	4	['NGF', 'OPN3', 'SLC22A3', 'EXPH5']	['LINC01885', 'NGF', 'OPN3', 'SLC22A3', 'PDGFD', 'EXPH5', 'IL1RAPL2', 'COL19A1', 'CHRM2', 'SEMA5A']	H23.30.001(0.3508)| H20.30.001(0.3072)| H20.30.002(0.1721)| H18.30.001(0.1699)| H19.30.004(0.0)	Balanced	Balanced	847_A04 (0.1068)|1955_B06 (0.0871)|930_C05 (0.0850)|1036_A03 (0.0741)|930_E05 (0.0610)|1036_B03 (0.0588)|2006_A05 (0.0458)|1955_C06 (0.0414)|1042_B06 (0.0392)|980_C02 (0.0370)|822_A01 (0.0305)|897_E03 (0.0283)|2013_C01 (0.0261)|1959_B02 (0.0261)|2018_B01 (0.0240)|2018_A01 (0.0218)|1042_C06 (0.0196)|1091_A05 (0.0196)|1959_A02 (0.0196)|930_A05 (0.0174)|1959_C02 (0.0109)|988_D05 (0.0109)|2016_B03 (0.0109)|847_B04 (0.0109)	0.1068	847_A04 (0.1068)|a total of 9215 cells in this dominant library	CaH(0.3224)| NAC(0.244)| CaB(0.1678)| CaT(0.0632)| Pu(0.0523)| PuPV(0.0479)| PuR(0.0436)| PuC(0.0414)| GPe(0.0131)| GPeR(0.0022)| GPi(0.0022)| GPeC(0.0)| SN(0.0)| SN-VTA(0.0)| STH(0.0)	Balanced	0	0	0	0	0	0.03	0.1978	6528	23628	3.62
AIT117_87	IN_87		AIT117_321	STR FS PTHLH ST18 GABA	cluster							263	3	['ADGRG6', 'SLC26A4-AS1', 'EYA4']	['CORT', 'ADGRG6', 'RASGRF2-AS1', 'SLC26A4-AS1', 'MYO5B', 'EYA4', 'SLC26A4', 'CMTM8', 'IL1RAPL2', 'CCBE1']	H20.30.002(0.346)| H20.30.001(0.2662)| H18.30.001(0.2395)| H23.30.001(0.1483)| H19.30.004(0.0)	Balanced	Balanced	822_A01 (0.1141)|847_A04 (0.1141)|1036_A03 (0.0951)|930_C05 (0.0646)|930_E05 (0.0646)|1036_B03 (0.0646)|1091_A05 (0.0570)|1036_C03 (0.0418)|1042_C06 (0.0304)|930_A05 (0.0304)|1955_C06 (0.0304)|1959_C02 (0.0266)|847_B04 (0.0228)|897_E03 (0.0228)|1955_B06 (0.0228)|891_A06 (0.0190)|2006_A05 (0.0152)|1959_B02 (0.0152)|930_D05 (0.0152)|1959_A02 (0.0152)|822_B01 (0.0152)|2018_A01 (0.0152)|1042_A06 (0.0152)|1042_B06 (0.0152)|930_F05 (0.0114)	0.1141	822_A01 (0.1141)|a total of 10559 cells in this dominant library	NAC(0.346)| CaH(0.2471)| PuR(0.1483)| CaB(0.1217)| Pu(0.057)| PuC(0.0494)| PuPV(0.019)| CaT(0.0076)| GPe(0.0038)| GPeC(0.0)| GPeR(0.0)| GPi(0.0)| SN(0.0)| SN-VTA(0.0)| STH(0.0)	Balanced	0	0	0	0	0	0.02	0.3748	6962	27611	3.97
AIT117_88	IN_88		AIT117_321	STR FS PTHLH ST18 GABA	cluster							319	3	['TAC3', 'IL1RAPL2', 'NDST4']	['BEST3', 'SFRP1', 'CRABP1', 'TAC3', 'IL1RAPL2', 'NDST4', 'CELF2-DT', 'THSD4', 'COL19A1', 'LMO4']	H20.30.002(0.3824)| H20.30.001(0.326)| H23.30.001(0.1693)| H18.30.001(0.1223)| H19.30.004(0.0)	Balanced	Balanced	1036_A03 (0.1693)|1042_B06 (0.1097)|1042_A06 (0.0721)|930_C05 (0.0690)|1036_C03 (0.0627)|930_E05 (0.0439)|847_A04 (0.0408)|1036_B03 (0.0408)|1042_C06 (0.0376)|891_A06 (0.0345)|1955_B06 (0.0345)|897_E03 (0.0313)|1959_A02 (0.0219)|2006_A05 (0.0219)|1955_C06 (0.0219)|1091_A05 (0.0219)|930_A05 (0.0188)|2013_C01 (0.0125)|1959_B02 (0.0125)|822_A01 (0.0125)|822_B01 (0.0125)	0.1693	1036_A03 (0.1693)|a total of 10559 cells in this dominant library	NAC(0.5486)| CaH(0.1755)| CaB(0.1442)| Pu(0.0313)| CaT(0.0282)| PuPV(0.0251)| PuC(0.0251)| PuR(0.0188)| GPe(0.0031)| GPeC(0.0)| GPeR(0.0)| GPi(0.0)| SN(0.0)| SN-VTA(0.0)| STH(0.0)	Balanced	0	0	0	0	0	0.02	0.2883	5429	16885	3.11
AIT117_92	IN_92		AIT117_330	STR LHX8 ST18 GABA	cluster							154	3	['AMIGO2', 'AC046195.2', 'LHX8']	['TPH2', 'AMIGO2', 'NMBR', 'AC046195.2', 'LHX8', 'AC046195.1', 'MALRD1', 'MOXD1', 'C5orf64', 'VCAN']	H23.30.001(0.5649)| H20.30.001(0.2078)| H20.30.002(0.1494)| H18.30.001(0.0779)| H19.30.004(0.0)	Balanced	Balanced	2006_B05 (0.1429)|2012_B05 (0.1234)|2013_B01 (0.1104)|1036_C03 (0.1039)|1482_A03 (0.0714)|2012_A05 (0.0649)|2013_A01 (0.0455)|1042_C06 (0.0455)|1091_A05 (0.0390)|960_B03 (0.0325)|2016_A03 (0.0260)|1042_B06 (0.0260)|1959_B02 (0.0195)|1110_B07 (0.0195)|930_B05 (0.0130)|1110_A07 (0.0130)|822_B01 (0.0130)|930_E05 (0.0130)|2058_B03 (0.0130)	0.1429	2006_B05 (0.1429)|a total of 6534 cells in this dominant library	GPi(0.3312)| NAC(0.2662)| GPe(0.2597)| GPeR(0.0325)| CaH(0.0195)| PuC(0.0195)| PuPV(0.0195)| CaB(0.013)| STH(0.013)| GPeC(0.0065)| CaT(0.0065)| Pu(0.0065)| PuR(0.0065)| SN(0.0)| SN-VTA(0.0)	Balanced	0	0	0	0	0.64	0.1176	0.1161	7147	29594.5	4.14
AIT117_93	IN_93		AIT117_330	STR LHX8 ST18 GABA	cluster							83	2	['RERGL', 'ZNF385D-AS2']	['PIK3C2G', 'GRXCR2', 'RERGL', 'AC016723.1', 'ZNF385D-AS2', 'GLT8D2', 'TSIX', 'SULF1', 'PRELID2', 'AC007368.1']	H18.30.001(0.759)| H23.30.001(0.1084)| H20.30.001(0.0964)| H20.30.002(0.0361)| H19.30.004(0.0)	Balanced	Balanced	1110_B07 (0.4458)|1110_A07 (0.2048)|1091_A05 (0.1084)|1959_A02 (0.0361)|1042_C06 (0.0361)|1036_B03 (0.0241)|1042_A06 (0.0241)|1042_B06 (0.0241)|2013_B01 (0.0241)|2013_C01 (0.0120)|897_E03 (0.0120)|2013_A01 (0.0120)|2012_A05 (0.0120)|930_E05 (0.0120)|2006_B05 (0.0120)	0.4458	1110_B07 (0.4458)|a total of 4786 cells in this dominant library	NAC(0.9036)| GPe(0.0361)| CaB(0.0361)| GPi(0.0241)| CaT(0.0)| GPeC(0.0)| CaH(0.0)| GPeR(0.0)| Pu(0.0)| PuC(0.0)| PuPV(0.0)| PuR(0.0)| SN(0.0)| SN-VTA(0.0)| STH(0.0)	Balanced	0	0	0	0	0.58	0.0441	0.0397	4443	12852	2.89
AIT117_94	IN_94		AIT117_330	STR LHX8 ST18 GABA	cluster							207	3	['RERGL', 'COL12A1', 'SULF1']	['PIK3C2G', 'RERGL', 'C12orf75', 'GLT8D2', 'COL12A1', 'SULF1', 'MYO1B', 'AC007368.1', 'PDZRN4', 'GABRG1']	H20.30.002(0.5024)| H20.30.001(0.2512)| H18.30.001(0.1256)| H23.30.001(0.1208)| H19.30.004(0.0)	Balanced	Balanced	1036_C03 (0.3623)|1042_A06 (0.0870)|1042_B06 (0.0821)|1036_B03 (0.0676)|1042_C06 (0.0676)|1091_A05 (0.0628)|1036_A03 (0.0338)|2013_B01 (0.0338)|1110_B07 (0.0338)|2006_B05 (0.0193)|930_A05 (0.0145)|1959_C02 (0.0145)|994_C03 (0.0145)|1959_A02 (0.0145)|1110_A07 (0.0145)	0.3623	1036_C03 (0.3623)|a total of 10219 cells in this dominant library	NAC(0.8261)| GPi(0.058)| GPe(0.029)| CaH(0.0193)| CaB(0.0193)| Pu(0.0193)| PuR(0.0145)| GPeR(0.0097)| SN(0.0048)| GPeC(0.0)| CaT(0.0)| PuPV(0.0)| PuC(0.0)| SN-VTA(0.0)| STH(0.0)	Balanced	0	0	0	0	0.5	0.02	0.3196	5477	16303	2.98
AIT117_95	IN_95		AIT117_322	STR TAC3 PLPP4 GABA	cluster							226	3	['IGFBP2', 'TRH', 'AC046195.2']	['IGFBP2', 'LINC02192', 'TRH', 'AC046195.2', 'LINC00457', 'DGKK', 'AC046195.1', 'ZNF385D-AS2', 'ADAMTS18', 'THSD7B']	H23.30.001(0.3761)| H20.30.001(0.2876)| H20.30.002(0.1726)| H18.30.001(0.1637)| H19.30.004(0.0)	Balanced	Balanced	988_E05 (0.0708)|930_D05 (0.0619)|822_A01 (0.0487)|1036_C03 (0.0398)|2016_B03 (0.0354)|2012_A05 (0.0354)|847_A04 (0.0310)|2006_B05 (0.0310)|2006_A05 (0.0265)|897_E03 (0.0265)|1959_B02 (0.0265)|1036_B03 (0.0265)|2018_B01 (0.0265)|847_B04 (0.0265)|847_C04 (0.0221)|930_F05 (0.0221)|930_E05 (0.0221)|2018_A01 (0.0221)|2013_B01 (0.0221)|1959_C02 (0.0221)|2013_A01 (0.0221)|980_C02 (0.0177)|2018_C01 (0.0177)|1110_A07 (0.0177)|988_D05 (0.0177)|960_B03 (0.0177)|847_D04 (0.0177)|930_C05 (0.0177)|930_B05 (0.0177)|1091_A05 (0.0133)|1110_B07 (0.0133)|2016_C03 (0.0133)|1036_A03 (0.0133)|2013_C01 (0.0133)|1955_C06 (0.0133)|1482_A03 (0.0133)	0.0708	988_E05 (0.0708)|a total of 10190 cells in this dominant library	PuC(0.1549)| NAC(0.1504)| PuPV(0.1372)| GPe(0.1062)| PuR(0.0973)| CaH(0.0929)| CaB(0.0929)| CaT(0.0619)| GPi(0.0487)| Pu(0.0354)| GPeR(0.0177)| STH(0.0044)| GPeC(0.0)| SN(0.0)| SN-VTA(0.0)	Balanced	0	0	0	0	0	0.08	0.2251	7164	28568	3.99
AIT117_96	IN_96		AIT117_322	STR TAC3 PLPP4 GABA	cluster							1037	3	['ADAMTS20', 'TAC3', 'CRABP1']	['CER1', 'GLP1R', 'ADAMTS20', 'TAC3', 'CRABP1', 'GLT8D2', 'GFRA2', 'MEF2C-AS2', 'LINC02223', 'H3F3B']	H20.30.001(0.3703)| H20.30.002(0.3607)| H18.30.001(0.1389)| H23.30.001(0.1302)| H19.30.004(0.0)	Balanced	Balanced	1036_C03 (0.1562)|1036_A03 (0.1340)|1036_B03 (0.1321)|1042_B06 (0.1003)|1042_C06 (0.0733)|1091_A05 (0.0530)|1042_A06 (0.0492)|1955_B06 (0.0434)|1110_B07 (0.0318)|847_A04 (0.0270)|1955_C06 (0.0212)|930_E05 (0.0212)|930_C05 (0.0203)|1959_A02 (0.0145)|1110_A07 (0.0125)|2006_B05 (0.0125)|930_A05 (0.0106)	0.1562	1036_C03 (0.1562)|a total of 10219 cells in this dominant library	NAC(0.757)| CaH(0.109)| CaB(0.0386)| Pu(0.0241)| GPe(0.0222)| GPi(0.0145)| CaT(0.0096)| PuR(0.0096)| GPeR(0.0087)| PuPV(0.0039)| PuC(0.0019)| STH(0.001)| GPeC(0.0)| SN(0.0)| SN-VTA(0.0)	Balanced	0	0	0	0	0	0	0.315	4587	11624	2.53
AIT117_97	IN_97		AIT117_322	STR TAC3 PLPP4 GABA	cluster							3220	2	['CHRNA3', 'ADAMTS18']	['CER1', 'LINC01837', 'CHRNA3', 'GLP1R', 'TAC3', 'ADAMTS18', 'CRABP1', 'SLC22A3', 'AC007614.1', 'GFRA2']	H23.30.001(0.3106)| H20.30.001(0.2742)| H18.30.001(0.2252)| H20.30.002(0.1894)| H19.30.004(0.0006)	Balanced	Balanced	847_A04 (0.0953)|897_E03 (0.0727)|930_C05 (0.0683)|930_E05 (0.0522)|822_B01 (0.0407)|988_D05 (0.0391)|980_C02 (0.0363)|2006_A05 (0.0335)|1036_B03 (0.0311)|2013_C01 (0.0283)|2006_B05 (0.0270)|1959_B02 (0.0270)|988_E05 (0.0227)|822_A01 (0.0220)|847_B04 (0.0217)|2018_B01 (0.0183)|960_B03 (0.0174)|1955_B06 (0.0174)|2018_C01 (0.0171)|2018_E01 (0.0171)|1091_A05 (0.0171)|1036_C03 (0.0158)|2013_A01 (0.0158)|1042_C06 (0.0149)|2013_B01 (0.0143)|2016_C03 (0.0134)|994_C03 (0.0134)|1959_C02 (0.0134)|1110_A07 (0.0134)|2012_A05 (0.0130)|1955_C06 (0.0127)|1110_B07 (0.0124)|891_A06 (0.0118)|930_A05 (0.0115)|2018_A01 (0.0115)	0.0953	847_A04 (0.0953)|a total of 9215 cells in this dominant library	CaH(0.2196)| CaB(0.1984)| NAC(0.1351)| PuPV(0.1016)| CaT(0.0984)| GPe(0.073)| PuR(0.0484)| GPi(0.0419)| PuC(0.0339)| Pu(0.0261)| GPeR(0.0186)| STH(0.0028)| GPeC(0.0012)| SN(0.0009)| SN-VTA(0.0)	Balanced	0	0	0	0	0	0.0227	0.1082	5638	17588	3.12
AIT117_98	IN_98		AIT117_322	STR TAC3 PLPP4 GABA	cluster							708	3	['AC044798.3', 'COL15A1', 'ADAMTS17']	['AC044798.3', 'VIPR2', 'AC106729.1', 'AC019068.1', 'COL15A1', 'ADAMTS17', 'MT-ATP8', 'CHST9', 'SYT2', 'MT-ND4L']	H20.30.001(0.6158)| H18.30.001(0.1653)| H20.30.002(0.154)| H23.30.001(0.0636)| H19.30.004(0.0014)	Balanced	Balanced	930_D05 (0.2726)|988_E05 (0.1737)|930_F05 (0.1229)|847_D04 (0.1031)|822_A01 (0.0650)|847_C04 (0.0297)|822_B01 (0.0268)|988_D05 (0.0254)|2018_A01 (0.0226)|988_C05 (0.0212)|930_E05 (0.0212)|930_B05 (0.0212)|930_C05 (0.0198)|2016_B03 (0.0198)|897_E03 (0.0184)	0.2726	930_D05 (0.2726)|a total of 8788 cells in this dominant library	PuC(0.4393)| PuPV(0.2387)| PuR(0.1935)| CaT(0.0466)| CaB(0.0424)| CaH(0.0268)| GPeR(0.0042)| GPe(0.0028)| GPi(0.0028)| STH(0.0014)| Pu(0.0014)| GPeC(0.0)| NAC(0.0)| SN(0.0)| SN-VTA(0.0)	Balanced	0	0	0	0	0	0.027	0.8001	6251.5	21367.5	3.42
AIT117_99	IN_99		AIT117_322	STR TAC3 PLPP4 GABA	cluster							691	3	['TRH', 'GRXCR2', 'LINC01837']	['LRRC38', 'TRH', 'GRXCR2', 'ADRA1D', 'LINC01837', 'GLP1R', 'SST', 'TAC3', 'ADAMTS18', 'THSD7B']	H20.30.001(0.3126)| H20.30.002(0.2663)| H23.30.001(0.2648)| H18.30.001(0.1563)| H19.30.004(0.0)	Balanced	Balanced	1036_A03 (0.0796)|2006_B05 (0.0709)|930_C05 (0.0695)|847_A04 (0.0680)|1036_B03 (0.0608)|1036_C03 (0.0521)|1955_C06 (0.0478)|1955_B06 (0.0463)|822_A01 (0.0449)|980_C02 (0.0405)|930_A05 (0.0376)|930_E05 (0.0362)|960_B03 (0.0333)|988_D05 (0.0304)|1042_C06 (0.0246)|1091_A05 (0.0246)|1959_C02 (0.0232)|897_E03 (0.0232)|1042_A06 (0.0203)|1042_B06 (0.0174)|2006_A05 (0.0130)|930_D05 (0.0116)|1959_A02 (0.0101)	0.0796	1036_A03 (0.0796)|a total of 10559 cells in this dominant library	NAC(0.2938)| CaH(0.2272)| GPe(0.0839)| CaT(0.0825)| CaB(0.081)| Pu(0.0709)| PuR(0.0579)| GPeR(0.0347)| GPi(0.0217)| PuPV(0.0217)| PuC(0.0217)| GPeC(0.0029)| SN(0.0)| SN-VTA(0.0)| STH(0.0)	Balanced	0	0	0	0	0	0.04	0.2819	6423	21296	3.32
AIT117_100	IN_100		AIT117_331	STR SST RSPO2 GABA	cluster							178	3	['MYO5B', 'FLT3', 'NXPH2']	['MYO5B', 'RSPO3', 'SATB1-AS1', 'FLT3', 'NXPH2', 'AC073332.1', 'SLC24A4', 'CALB1', 'GRIK1', 'SOX6']	H20.30.001(0.3427)| H23.30.001(0.2528)| H20.30.002(0.2303)| H18.30.001(0.1685)| H19.30.004(0.0056)	Balanced	Balanced	980_C02 (0.1180)|822_B01 (0.0562)|988_C05 (0.0449)|925_F03 (0.0449)|1959_A02 (0.0449)|1042_B06 (0.0393)|1955_C06 (0.0393)|930_E05 (0.0393)|847_C04 (0.0393)|930_C05 (0.0337)|822_A01 (0.0337)|897_E03 (0.0337)|1036_C03 (0.0281)|1482_A03 (0.0281)|2018_E01 (0.0281)|988_D05 (0.0225)|847_A04 (0.0225)|988_E05 (0.0225)|1959_C02 (0.0225)|1036_B03 (0.0169)|2016_A03 (0.0169)|2013_C01 (0.0169)|930_D05 (0.0169)|2013_B01 (0.0169)|960_B03 (0.0112)|930_F05 (0.0112)|2013_A01 (0.0112)|891_A06 (0.0112)|2012_B05 (0.0112)|1036_A03 (0.0112)|1091_A05 (0.0112)|1042_A06 (0.0112)	0.118	980_C02 (0.118)|a total of 6906 cells in this dominant library	CaT(0.2191)| NAC(0.1798)| PuPV(0.118)| CaB(0.1067)| GPi(0.073)| CaH(0.0618)| Pu(0.0618)| SN(0.0506)| PuR(0.0506)| PuC(0.0337)| GPe(0.0225)| STH(0.0112)| GPeR(0.0112)| GPeC(0.0)| SN-VTA(0.0)	Balanced	0	0	0	0	0	0	0.1617	5309	19160.5	3.61
AIT117_101	IN_101		AIT117_331	STR SST RSPO2 GABA	cluster							276	3	['SST', 'SATB1', 'SATB1-AS1']	['NMU', 'NPAS1', 'SST', 'SATB1', 'SATB1-AS1', 'FLT3', 'PAWR', 'TRHDE-AS1', 'TRHDE', 'GRIN3A']	H23.30.001(0.413)| H20.30.002(0.2862)| H18.30.001(0.1703)| H20.30.001(0.1304)| H19.30.004(0.0)	Balanced	Balanced	1955_C06 (0.1486)|988_C05 (0.0942)|822_A01 (0.0688)|2018_E01 (0.0580)|847_C04 (0.0507)|925_F03 (0.0507)|897_E03 (0.0362)|980_C02 (0.0362)|1959_A02 (0.0326)|1955_B06 (0.0290)|822_B01 (0.0254)|930_A05 (0.0254)|2018_C01 (0.0254)|1036_A03 (0.0217)|1959_C02 (0.0217)|2013_C01 (0.0181)|930_E05 (0.0181)|930_D05 (0.0181)|988_E05 (0.0181)|988_D05 (0.0181)|2018_B01 (0.0145)|2018_A01 (0.0145)|2016_B03 (0.0145)|847_A04 (0.0145)|847_D04 (0.0109)|1036_B03 (0.0109)|1091_A05 (0.0109)|930_B05 (0.0109)|2012_B05 (0.0109)	0.1486	1955_C06 (0.1486)|a total of 8987 cells in this dominant library	CaT(0.2101)| Pu(0.1703)| PuPV(0.1123)| NAC(0.0906)| PuR(0.0833)| CaB(0.0833)| CaH(0.0797)| PuC(0.0688)| SN(0.0507)| GPe(0.0254)| GPi(0.0217)| GPeR(0.0036)| GPeC(0.0)| SN-VTA(0.0)| STH(0.0)	Balanced	0	0	0	0	0.24	0.0238	0.2494	5853	21766.5	3.72
AIT117_106	IN_106		AIT117_332	STR SST Chodl GABA	cluster							206	2	['NPY', 'IL1RAPL2']	['NPY2R', 'CRHBP', 'NPY', 'NXPH2', 'IL1RAPL2', 'NOS1', 'NDST4', 'COL24A1', 'TRPC6', 'TACR1']	H23.30.001(0.6214)| H18.30.001(0.1311)| H20.30.001(0.1262)| H20.30.002(0.1214)| H19.30.004(0.0)	Balanced	Balanced	1955_C06 (0.2087)|2018_E01 (0.0534)|1091_A05 (0.0485)|2012_C05 (0.0437)|1959_A02 (0.0388)|2016_C03 (0.0388)|2018_A01 (0.0388)|980_C02 (0.0388)|2018_C01 (0.0388)|1482_A03 (0.0291)|2016_B03 (0.0291)|2018_B01 (0.0291)|988_C05 (0.0243)|1959_C02 (0.0243)|822_B01 (0.0243)|988_D05 (0.0194)|1955_B06 (0.0194)|925_F03 (0.0146)|2006_B05 (0.0146)|930_C05 (0.0146)|1959_B02 (0.0146)|1042_C06 (0.0146)|1036_A03 (0.0146)|847_A04 (0.0146)|847_B04 (0.0146)	0.2087	1955_C06 (0.2087)|a total of 8987 cells in this dominant library	Pu(0.233)| CaT(0.1796)| NAC(0.1505)| PuPV(0.1068)| PuC(0.0777)| CaH(0.0728)| GPe(0.0583)| GPi(0.0437)| PuR(0.0291)| CaB(0.0194)| SN(0.0194)| GPeR(0.0097)| GPeC(0.0)| SN-VTA(0.0)| STH(0.0)	Balanced	0	0	0	0	0	0.058	0.1378	6295	26770.5	4.25
AIT117_107	IN_107		AIT117_332	STR SST Chodl GABA	cluster							98	3	['AC002072.1', 'NPY', 'DIRAS3']	['AC002072.1', 'CORT', 'NPY', 'LINC02133', 'SST', 'DIRAS3', 'MOXD1', 'FBN2', 'LINC01776', 'SFTA3']	H23.30.001(0.4694)| H20.30.001(0.2755)| H20.30.002(0.2041)| H18.30.001(0.051)| H19.30.004(0.0)	Balanced	Balanced	1482_A03 (0.1837)|2012_B05 (0.1327)|1036_C03 (0.1020)|2006_B05 (0.0918)|1042_A06 (0.0918)|2013_B01 (0.0612)|1042_C06 (0.0510)|2016_A03 (0.0408)|2018_C01 (0.0408)|1110_B07 (0.0408)|1036_B03 (0.0204)|1042_B06 (0.0204)|2013_A01 (0.0204)|2012_A05 (0.0204)|1036_A03 (0.0102)|1110_A07 (0.0102)|1959_A02 (0.0102)|1955_B06 (0.0102)|1959_C02 (0.0102)|2006_A05 (0.0102)|2013_C01 (0.0102)|1959_B02 (0.0102)	0.1837	1482_A03 (0.1837)|a total of 4968 cells in this dominant library	GPi(0.4184)| NAC(0.3571)| GPe(0.1735)| CaH(0.0204)| CaB(0.0204)| Pu(0.0102)| CaT(0.0)| GPeR(0.0)| GPeC(0.0)| PuC(0.0)| PuPV(0.0)| PuR(0.0)| SN(0.0)| SN-VTA(0.0)| STH(0.0)	Balanced	0	0	0	0	0	0.1143	0.1069	7316	37408	5.11
AIT117_108	IN_108		AIT117_332	STR SST Chodl GABA	cluster							1022	2	['TRPM8', 'NPY']	['LINC00348', 'TRPM8', 'CORT', 'NPY', 'TLL2', 'SST', 'TRPC7', 'CRHR2', 'FBN2', 'NOS1']	H23.30.001(0.4423)| H20.30.001(0.2583)| H18.30.001(0.1595)| H20.30.002(0.1399)| H19.30.004(0.0)	Balanced	Balanced	2016_C03 (0.1037)|980_C02 (0.0656)|988_E05 (0.0587)|2018_B01 (0.0519)|822_B01 (0.0431)|2016_B03 (0.0411)|847_A04 (0.0342)|2018_E01 (0.0303)|1955_C06 (0.0303)|2018_A01 (0.0294)|988_D05 (0.0264)|2018_C01 (0.0264)|847_D04 (0.0245)|930_F05 (0.0245)|2006_B05 (0.0225)|930_C05 (0.0215)|847_C04 (0.0215)|1036_B03 (0.0215)|2006_A05 (0.0196)|930_D05 (0.0196)|930_B05 (0.0196)|930_E05 (0.0196)|1955_B06 (0.0196)|897_E03 (0.0176)|1091_A05 (0.0157)|988_C05 (0.0157)|1110_A07 (0.0147)|1042_B06 (0.0147)|1959_C02 (0.0147)|2013_C01 (0.0137)|1110_B07 (0.0127)|1042_A06 (0.0127)|1959_B02 (0.0117)|1036_A03 (0.0108)	0.1037	2016_C03 (0.1037)|a total of 8224 cells in this dominant library	PuPV(0.2789)| CaT(0.1448)| PuC(0.1341)| NAC(0.1233)| CaH(0.089)| CaB(0.0734)| GPe(0.0577)| Pu(0.045)| PuR(0.0391)| GPi(0.0117)| GPeC(0.002)| GPeR(0.001)| SN(0.0)| SN-VTA(0.0)| STH(0.0)	Balanced	0	0	0	0	0	0.1	0.121	7327.5	36451.5	4.97
AIT117_109	IN_109		AIT117_315	STR Cholinergic GABA	cluster							143	2	['SLC5A7', 'CHAT']	['SLC5A7', 'CHAT', 'CNBD1', 'Z96074.1', 'AC091576.1', 'OR8A1', 'COL6A6', 'SLC17A8', 'LHX8', 'ISL1']	H23.30.001(0.8112)| H20.30.001(0.1189)| H18.30.001(0.0559)| H20.30.002(0.014)| H19.30.004(0.0)	Balanced	Balanced	2016_A03 (0.2028)|2016_C03 (0.1888)|2012_A05 (0.1189)|2012_B05 (0.1119)|2013_B01 (0.0839)|1482_A03 (0.0699)|1955_B06 (0.0350)|2006_B05 (0.0280)|1110_B07 (0.0210)|980_C02 (0.0210)|847_A04 (0.0210)|988_E05 (0.0140)|960_B03 (0.0140)	0.2028	2016_A03 (0.2028)|a total of 8401 cells in this dominant library	GPi(0.4755)| PuPV(0.2028)| GPe(0.1538)| NAC(0.0559)| CaH(0.0559)| CaT(0.028)| CaB(0.014)| GPeR(0.014)| GPeC(0.0)| Pu(0.0)| PuC(0.0)| PuR(0.0)| SN(0.0)| SN-VTA(0.0)| STH(0.0)	Balanced	0	0	0	0	0	0.12	0.1113	7201	42155	5.85
AIT117_110	IN_110		AIT117_323	NDB SI LHX6 LHX8 GBX1	cluster							85	4	['CD36', 'AC007319.1', 'TRPC3', 'PDE3A']	['CD36', 'AC007319.1', 'RGS5', 'TRPC3', 'ATP1A2', 'PDE3A', 'AC008415.1', 'CPNE4', 'TSHZ2', 'ADARB2']	H23.30.001(0.9882)| H20.30.001(0.0118)| H18.30.001(0.0)| H19.30.004(0.0)| H20.30.002(0.0)	Cautious	Cautious	2016_A03 (0.9882)|1482_A03 (0.0118)	0.9882	2016_A03 (0.9882)|a total of 8401 cells in this dominant library	GPi(1.0)| CaH(0.0)| CaB(0.0)| CaT(0.0)| GPe(0.0)| GPeC(0.0)| GPeR(0.0)| NAC(0.0)| Pu(0.0)| PuC(0.0)| PuPV(0.0)| PuR(0.0)| SN(0.0)| SN-VTA(0.0)| STH(0.0)	Cautious	0	0.24	0	0.24	0.24	0.14	0.1226	2749	5292	1.93
AIT117_111	IN_111		AIT117_323	NDB SI LHX6 LHX8 GBX1	cluster							138	3	['DISC1FP1', 'TRPC3', 'TMEM179']	['DISC1FP1', 'TRPC3', 'TMEM179', 'SNTG2', 'OVCH1', 'LINC02112', 'AL356124.1', 'NXPH1', 'ADARB2', 'CDH13']	H20.30.001(0.971)| H23.30.001(0.0217)| H20.30.002(0.0072)| H18.30.001(0.0)| H19.30.004(0.0)	Cautious	Balanced	994_C03 (0.8841)|960_B03 (0.0870)|2013_B01 (0.0145)	0.8841	994_C03 (0.8841)|a total of 4714 cells in this dominant library	GPi(0.9058)| GPeR(0.087)| STH(0.0072)| CaT(0.0)| CaH(0.0)| GPeC(0.0)| CaB(0.0)| GPe(0.0)| NAC(0.0)| PuC(0.0)| Pu(0.0)| PuPV(0.0)| PuR(0.0)| SN(0.0)| SN-VTA(0.0)	Balanced	0	0.39	0	0.39	0.39	0.16	0.0576	3270.5	7476	2.29
AIT117_112	IN_112		AIT117_327	STR VIP GABA	cluster							77	2	['SLCO2A1', 'AC006305.1']	['SLCO2A1', 'LINC01416', 'AC006305.1', 'NNMT', 'KCNG1', 'DCN', 'AL391832.4', 'AC092640.1', 'AL589693.1', 'CCK']	H18.30.001(0.3896)| H20.30.002(0.2468)| H20.30.001(0.2208)| H23.30.001(0.1429)| H19.30.004(0.0)	Balanced	Balanced	925_F03 (0.3247)|988_C05 (0.1948)|1482_A03 (0.1558)|1955_C06 (0.0909)|822_B01 (0.0390)|1959_C02 (0.0260)|1091_A05 (0.0260)|988_D05 (0.0130)|1036_B03 (0.0130)|930_E05 (0.0130)|1036_C03 (0.0130)|1042_B06 (0.0130)|1042_C06 (0.0130)|2016_C03 (0.0130)|2018_B01 (0.0130)|1110_B07 (0.0130)|847_C04 (0.0130)|988_E05 (0.0130)	0.3247	925_F03 (0.3247)|a total of 3479 cells in this dominant library	SN(0.3247)| CaT(0.2078)| GPi(0.1558)| Pu(0.1169)| PuPV(0.0909)| NAC(0.0909)| CaB(0.013)| GPeR(0.0)| GPeC(0.0)| GPe(0.0)| CaH(0.0)| PuC(0.0)| PuR(0.0)| SN-VTA(0.0)| STH(0.0)	Balanced	0	0	0	0	0	0.043	0.3562	5771	21517	3.73
AIT117_113	IN_113		AIT117_326	BN LAMP5 CXCL14 GABA	cluster							92	3	['SP8', 'DDR2', 'WIF1']	['SP8', 'LINC01416', 'AC006305.1', 'AC064875.1', 'DDR2', 'WIF1', 'CXCL14', 'CHRNA7', 'IL1RAPL2', 'SDK2']	H18.30.001(0.3043)| H23.30.001(0.2935)| H20.30.002(0.2391)| H20.30.001(0.163)| H19.30.004(0.0)	Balanced	Balanced	925_F03 (0.1957)|988_C05 (0.0978)|847_A04 (0.0435)|2018_E01 (0.0326)|930_C05 (0.0326)|1955_C06 (0.0326)|897_E03 (0.0326)|2012_B05 (0.0326)|2018_A01 (0.0326)|1482_A03 (0.0326)|2006_A05 (0.0217)|2006_B05 (0.0217)|930_B05 (0.0217)|2012_C05 (0.0217)|1959_A02 (0.0217)|1959_B02 (0.0217)|980_C02 (0.0217)|1959_C02 (0.0217)|988_D05 (0.0217)|988_E05 (0.0217)|1036_C03 (0.0217)|1036_A03 (0.0217)|1042_B06 (0.0217)|822_B01 (0.0217)|847_C04 (0.0109)|847_D04 (0.0109)|2018_C01 (0.0109)|2016_C03 (0.0109)|930_A05 (0.0109)|2013_A01 (0.0109)|930_D05 (0.0109)|1036_B03 (0.0109)|1042_A06 (0.0109)|1110_B07 (0.0109)|1091_A05 (0.0109)|960_B03 (0.0109)	0.1957	925_F03 (0.1957)|a total of 3479 cells in this dominant library	CaT(0.1957)| SN(0.1957)| NAC(0.1304)| CaH(0.1087)| PuC(0.0761)| PuPV(0.0652)| GPi(0.0652)| Pu(0.0543)| CaB(0.0543)| GPe(0.0435)| GPeR(0.0109)| GPeC(0.0)| PuR(0.0)| SN-VTA(0.0)| STH(0.0)	Balanced	0	0	0	0.39	0.39	0	0.1557	5410.5	18792.5	3.47
AIT117_114	IN_114		AIT117_327	STR VIP GABA	cluster							65	3	['FREM2', 'TNFAIP8L3', 'PTGFR']	['HTR3A', 'FREM2', 'SLC17A8', 'TNFAIP8L3', 'ZNF385D-AS2', 'PTGFR', 'LINC01470', 'CLMP', 'GABRG1', 'TRPC4']	H18.30.001(0.5385)| H20.30.002(0.3077)| H20.30.001(0.0923)| H23.30.001(0.0615)| H19.30.004(0.0)	Balanced	Balanced	925_F03 (0.5385)|988_C05 (0.3077)|1482_A03 (0.0923)|2018_E01 (0.0308)|2012_B05 (0.0154)|1959_A02 (0.0154)	0.5385	925_F03 (0.5385)|a total of 3479 cells in this dominant library	SN(0.5385)| CaT(0.3385)| GPi(0.1077)| NAC(0.0154)| GPe(0.0)| CaH(0.0)| CaB(0.0)| GPeR(0.0)| GPeC(0.0)| PuC(0.0)| Pu(0.0)| PuPV(0.0)| PuR(0.0)| SN-VTA(0.0)| STH(0.0)	Balanced	0	0	0	0	0	0.093	0.7349	7476	39402	5.27
AIT117_120	IN_120		AIT117_333	BN LAMP5 LHX6 GABA	cluster							347	2	['ADGRG6', 'ITGA8']	['LINC01344', 'ADGRG6', 'AL136456.1', 'CA3', 'EYA4', 'ITGA8', 'PDGFD', 'CCBE1', 'SLC27A6', 'CHST9']	H23.30.001(0.3343)| H18.30.001(0.2651)| H20.30.002(0.245)| H20.30.001(0.1556)| H19.30.004(0.0)	Balanced	Balanced	988_C05 (0.2161)|925_F03 (0.1873)|1955_C06 (0.1412)|1482_A03 (0.1268)|2012_B05 (0.0403)|2013_B01 (0.0375)|1959_A02 (0.0346)|847_C04 (0.0288)|1110_B07 (0.0173)|988_E05 (0.0173)|1110_A07 (0.0173)|1042_A06 (0.0144)|1959_C02 (0.0115)|2016_A03 (0.0115)|2018_B01 (0.0115)	0.2161	988_C05 (0.2161)|a total of 5279 cells in this dominant library	CaT(0.2277)| GPi(0.219)| SN(0.1902)| Pu(0.1527)| NAC(0.0893)| PuPV(0.0576)| CaB(0.0231)| CaH(0.0173)| GPe(0.0086)| PuC(0.0058)| STH(0.0058)| GPeR(0.0029)| GPeC(0.0)| PuR(0.0)| SN-VTA(0.0)	Balanced	0	0	0	0	0	0.06	0.3123	6258	27525	4.4
AIT117_122	IN_122		AIT117_333	BN LAMP5 LHX6 GABA	cluster							152	3	['SLC38A4', 'HTR7', 'COL4A1']	['SLC38A4', 'LINC02653', 'CHRDL1', 'TMEM255A', 'HTR7', 'COL4A1', 'CCK', 'RXFP1', 'CHST9', 'SLCO5A1']	H18.30.001(0.5197)| H20.30.002(0.4079)| H20.30.001(0.0526)| H23.30.001(0.0197)| H19.30.004(0.0)	Balanced	Balanced	925_F03 (0.5197)|988_C05 (0.3947)|1482_A03 (0.0395)|2012_B05 (0.0132)	0.5197	925_F03 (0.5197)|a total of 3479 cells in this dominant library	SN(0.5197)| CaT(0.3947)| GPi(0.0526)| Pu(0.0066)| PuR(0.0066)| NAC(0.0066)| GPeR(0.0066)| STH(0.0066)| GPeC(0.0)| CaB(0.0)| CaH(0.0)| GPe(0.0)| PuC(0.0)| PuPV(0.0)| SN-VTA(0.0)	Balanced	0	0	0	0	0	0.0286	0.7619	6504	29496	4.54
AIT117_126	IN_126		AIT117_314	SN STH VTA Glut	cluster							69	3	['AP000829.1', 'ADAMTSL1', 'RNF220']	['AP000829.1', 'SLC5A11', 'ADAMTSL1', 'SEMA3C', 'MOBP', 'RNF220', 'TMEM144', 'ST18', 'NXPH1', 'ZNF804B']	H20.30.001(0.6377)| H23.30.001(0.3623)| H18.30.001(0.0)| H19.30.004(0.0)| H20.30.002(0.0)	Balanced	Balanced	994_C03 (0.5217)|2018_D01 (0.2609)|960_B03 (0.1159)|2016_A03 (0.0580)|2058_C03 (0.0290)|2012_A05 (0.0145)	0.5217	994_C03 (0.5217)|a total of 4714 cells in this dominant library	GPi(0.8406)| GPeR(0.1159)| SN(0.029)| GPe(0.0145)| CaT(0.0)| CaB(0.0)| CaH(0.0)| GPeC(0.0)| NAC(0.0)| PuC(0.0)| Pu(0.0)| PuPV(0.0)| PuR(0.0)| SN-VTA(0.0)| STH(0.0)	Balanced	0	0.24	0	0	0	0.12	0.0602	3066	5726	1.87
AIT117_127	IN_127		AIT117_334	GP MEIS2 SOX6 GABA	cluster							164	3	['GPC3', 'AC113383.1', 'AL445123.2']	['GPC3', 'NPNT', 'AC113383.1', 'AL445123.2', 'OVCH1', 'CUX2', 'CDH13', 'FOXP2', 'ADARB2', 'CDH6']	H23.30.001(0.9024)| H20.30.001(0.0671)| H18.30.001(0.0183)| H20.30.002(0.0122)| H19.30.004(0.0)	Cautious	Balanced	2006_B05 (0.2805)|2018_C01 (0.1829)|2012_A05 (0.1707)|2013_A01 (0.1037)|960_B03 (0.0549)|2012_B05 (0.0549)|2016_A03 (0.0488)|2016_C03 (0.0366)|822_B01 (0.0122)|2018_D01 (0.0122)	0.2805	2006_B05 (0.2805)|a total of 6534 cells in this dominant library	GPe(0.7378)| GPi(0.128)| GPeR(0.0549)| PuPV(0.0488)| CaT(0.0122)| NAC(0.0122)| GPeC(0.0061)| CaB(0.0)| CaH(0.0)| Pu(0.0)| PuC(0.0)| PuR(0.0)| SN(0.0)| SN-VTA(0.0)| STH(0.0)	Balanced	0	0	0	0	0	0.1149	0.0522	8342.5	48670.5	5.83
AIT117_128	IN_128		AIT117_334	GP MEIS2 SOX6 GABA	cluster							457	3	['CYP26B1', 'PRSS12', 'NXPH1']	['CYP26B1', 'AC093765.2', 'PRSS12', 'TRPC3', 'CUX2', 'NXPH1', 'CDH13', 'SOX6', 'CLSTN2', 'ARHGAP24']	H23.30.001(0.8972)| H20.30.001(0.0832)| H18.30.001(0.0131)| H20.30.002(0.0066)| H19.30.004(0.0)	Balanced	Balanced	2012_A05 (0.4464)|2006_B05 (0.2254)|2013_A01 (0.0941)|2018_C01 (0.0810)|960_B03 (0.0700)|2016_A03 (0.0263)	0.4464	2012_A05 (0.4464)|a total of 7367 cells in this dominant library	GPe(0.8468)| GPeR(0.07)| GPi(0.046)| PuPV(0.0175)| CaB(0.0066)| NAC(0.0066)| CaT(0.0044)| PuR(0.0022)| CaH(0.0)| GPeC(0.0)| Pu(0.0)| PuC(0.0)| SN(0.0)| SN-VTA(0.0)| STH(0.0)	Balanced	0	0	0	0	0	0.08	0.0746	8635	54816	6.35
AIT117_129	IN_129		AIT117_334	GP MEIS2 SOX6 GABA	cluster							141	4	['CYP19A1', 'M1AP', 'PDE11A', 'AC110023.1']	['CYP19A1', 'M1AP', 'ANO2', 'PDE11A', 'CNGB1', 'AC110023.1', 'ST8SIA6', 'PROX1-AS1', 'PROX1', 'KCNH5']	H20.30.002(0.4043)| H23.30.001(0.3901)| H20.30.001(0.2057)| H18.30.001(0.0)| H19.30.004(0.0)	Balanced	Balanced	988_C05 (0.4043)|1482_A03 (0.2057)|2012_B05 (0.1773)|2016_A03 (0.1702)|2013_B01 (0.0426)	0.4043	988_C05 (0.4043)|a total of 5279 cells in this dominant library	GPi(0.5957)| CaT(0.4043)| CaB(0.0)| CaH(0.0)| GPe(0.0)| GPeC(0.0)| GPeR(0.0)| NAC(0.0)| Pu(0.0)| PuC(0.0)| PuPV(0.0)| PuR(0.0)| SN(0.0)| SN-VTA(0.0)| STH(0.0)	Balanced	0	0	0	0	0	0.0714	0.2643	7828	42468	5.43
AIT117_130	IN_130		AIT117_334	GP MEIS2 SOX6 GABA	cluster							101	5	['AC093765.3', 'AL109930.1', 'MDFIC', 'CMTM8', 'STK32B']	['AC093765.3', 'AL109930.1', 'AL133166.1', 'MDFIC', 'CMTM8', 'STK32B', 'PROX1-AS1', 'THSD4', 'SOX6', 'GRAMD1C']	H23.30.001(0.7228)| H20.30.001(0.2079)| H20.30.002(0.0693)| H18.30.001(0.0)| H19.30.004(0.0)	Balanced	Balanced	2012_B05 (0.3069)|1482_A03 (0.1881)|2016_A03 (0.1881)|2012_A05 (0.0792)|2013_B01 (0.0792)|988_C05 (0.0594)|2018_C01 (0.0396)|2013_A01 (0.0297)|960_B03 (0.0198)	0.3069	2012_B05 (0.3069)|a total of 6229 cells in this dominant library	GPi(0.7624)| GPe(0.1485)| CaT(0.0594)| GPeR(0.0198)| NAC(0.0099)| CaH(0.0)| CaB(0.0)| GPeC(0.0)| Pu(0.0)| PuC(0.0)| PuPV(0.0)| PuR(0.0)| SN(0.0)| SN-VTA(0.0)| STH(0.0)	Balanced	0	0	0	0	0	0.1304	0.1358	8245	49242	5.97
AIT117_131	IN_131		AIT117_334	GP MEIS2 SOX6 GABA	cluster							85	5	['AL109930.1', 'OPRK1', 'SCN5A', 'KCNK13', 'HTR2A']	['AL109930.1', 'OPRK1', 'SCN5A', 'KCNK13', 'HTR2A', 'NPNT', 'STAC', 'PCDH19', 'GDA', 'RMST']	H23.30.001(0.5529)| H20.30.001(0.3882)| H20.30.002(0.0471)| H18.30.001(0.0118)| H19.30.004(0.0)	Balanced	Balanced	1482_A03 (0.3882)|2012_B05 (0.2471)|2016_A03 (0.1412)|2012_A05 (0.0588)|2013_B01 (0.0471)|988_C05 (0.0353)|2013_A01 (0.0235)|2058_C03 (0.0235)|2018_C01 (0.0118)|930_B05 (0.0118)|988_D05 (0.0118)	0.3882	1482_A03 (0.3882)|a total of 4968 cells in this dominant library	GPi(0.8235)| GPe(0.0941)| CaT(0.0471)| SN(0.0235)| PuC(0.0118)| CaH(0.0)| CaB(0.0)| GPeR(0.0)| GPeC(0.0)| Pu(0.0)| NAC(0.0)| PuPV(0.0)| PuR(0.0)| SN-VTA(0.0)| STH(0.0)	Balanced	0	0	0	0	0	0.1029	0.1229	7791	45634	5.86
AIT117_132	IN_132		AIT117_334	GP MEIS2 SOX6 GABA	cluster							124	3	['KLRG2', 'CACNG5', 'NPNT']	['KLRG2', 'AC002072.1', 'LINC02133', 'CACNG5', 'NDST4', 'NPNT', 'OVCH1', 'CUX2', 'RMST', 'SOX6']	H23.30.001(0.8387)| H20.30.001(0.1371)| H20.30.002(0.0242)| H18.30.001(0.0)| H19.30.004(0.0)	Balanced	Balanced	2012_A05 (0.3871)|2012_B05 (0.2258)|1482_A03 (0.1048)|2016_A03 (0.0726)|2013_B01 (0.0565)|2018_C01 (0.0403)|2016_C03 (0.0323)|988_C05 (0.0161)|960_B03 (0.0161)|2013_A01 (0.0161)	0.3871	2012_A05 (0.3871)|a total of 7367 cells in this dominant library	GPi(0.4597)| GPe(0.4516)| PuPV(0.0403)| GPeR(0.0161)| CaT(0.0161)| NAC(0.0161)| CaB(0.0)| GPeC(0.0)| CaH(0.0)| Pu(0.0)| PuC(0.0)| PuR(0.0)| SN(0.0)| SN-VTA(0.0)| STH(0.0)	Balanced	0	0	0	0	0	0.1146	0.1809	8094	44190	5.46
AIT117_133	IN_133		AIT117_334	GP MEIS2 SOX6 GABA	cluster							115	3	['CYP19A1', 'NR2E1', 'LINC00683']	['CFAP58', 'FREM3', 'CYP19A1', 'QRFPR', 'NR2E1', 'LINC00683', 'SCN5A', 'ESR1', 'CNGB1', 'NXPH2']	H20.30.002(0.5217)| H23.30.001(0.2522)| H20.30.001(0.2261)| H18.30.001(0.0)| H19.30.004(0.0)	Balanced	Balanced	988_C05 (0.5217)|1482_A03 (0.2261)|2013_B01 (0.0870)|2012_B05 (0.0696)|2016_A03 (0.0696)|1959_A02 (0.0174)	0.5217	988_C05 (0.5217)|a total of 5279 cells in this dominant library	CaT(0.5217)| GPi(0.4522)| NAC(0.0174)| CaB(0.0087)| CaH(0.0)| GPeC(0.0)| GPe(0.0)| GPeR(0.0)| Pu(0.0)| PuC(0.0)| PuPV(0.0)| PuR(0.0)| SN(0.0)| SN-VTA(0.0)| STH(0.0)	Balanced	0	0	0	0	0	0.0857	0.1513	8328	58183	6.99
AIT117_134	IN_134		AIT117_335	GP SOX6 KCNA1 GABA	cluster							540	3	['FGF10-AS1', 'ASAH2', 'AC124254.2']	['FER1L6', 'FGF10', 'FGF10-AS1', 'ASAH2', 'AC124254.2', 'LYPD1', 'FBN2', 'MIR34AHG', 'SLC27A6', 'DNAI1']	H23.30.001(0.6741)| H20.30.001(0.3056)| H20.30.002(0.0148)| H18.30.001(0.0056)| H19.30.004(0.0)	Balanced	Balanced	2006_B05 (0.4204)|960_B03 (0.2630)|2012_A05 (0.1463)|2013_A01 (0.0852)|994_C03 (0.0352)|1036_C03 (0.0148)|2018_C01 (0.0130)	0.4204	2006_B05 (0.4204)|a total of 6534 cells in this dominant library	GPe(0.6648)| GPeR(0.263)| GPi(0.0444)| NAC(0.0167)| PuPV(0.0074)| GPeC(0.0037)| CaT(0.0)| CaH(0.0)| CaB(0.0)| Pu(0.0)| PuC(0.0)| PuR(0.0)| SN(0.0)| SN-VTA(0.0)| STH(0.0)	Balanced	0	0	0	0	0	0.0839	0.0434	8487	45560.5	5.37
AIT117_135	IN_135		AIT117_335	GP SOX6 KCNA1 GABA	cluster							329	3	['ASAH2', 'PVALB', 'CHRNA2']	['AC012355.1', 'AC026746.1', 'ASAH2', 'PVALB', 'CHRNA2', 'PPP1R1C', 'LINC00836', 'MIR34AHG', 'COL6A1', 'DNAI1']	H23.30.001(0.9514)| H20.30.001(0.0486)| H18.30.001(0.0)| H19.30.004(0.0)| H20.30.002(0.0)	Cautious	Balanced	2012_A05 (0.8237)|2018_C01 (0.0669)|988_E05 (0.0365)|2006_B05 (0.0243)|2013_A01 (0.0243)|960_B03 (0.0122)|2016_A03 (0.0122)	0.8237	2012_A05 (0.8237)|a total of 7367 cells in this dominant library	GPe(0.9392)| PuPV(0.0365)| GPeR(0.0122)| GPi(0.0122)| CaT(0.0)| CaB(0.0)| CaH(0.0)| GPeC(0.0)| NAC(0.0)| Pu(0.0)| PuC(0.0)| PuR(0.0)| SN(0.0)| SN-VTA(0.0)| STH(0.0)	Balanced	0	0	0	0	0	0.05	0.0658	9794	70586	7.21
AIT117_136	IN_136		AIT117_336	BN MEIS2 GABA	cluster							381	6	['AC231759.2', 'NEK5', 'SCN5A', 'CNGB1', 'SLC5A8', 'NPNT']	['AC231759.2', 'NEK5', 'SCN5A', 'CNGB1', 'SLC5A8', 'NPNT', 'SLC22A10', 'GABRG1', 'GLRA3', 'PCED1B']	H23.30.001(0.4987)| H20.30.001(0.3333)| H20.30.002(0.1601)| H18.30.001(0.0079)| H19.30.004(0.0)	Balanced	Balanced	1482_A03 (0.3281)|2012_B05 (0.1286)|2018_C01 (0.1207)|2013_B01 (0.1181)|988_C05 (0.0997)|2013_A01 (0.0577)|1036_C03 (0.0499)|2016_A03 (0.0236)|2012_A05 (0.0131)|2013_C01 (0.0105)	0.3281	1482_A03 (0.3281)|a total of 4968 cells in this dominant library	GPi(0.5984)| GPe(0.1995)| CaT(0.1024)| NAC(0.0656)| CaB(0.0131)| PuPV(0.0052)| STH(0.0052)| SN(0.0052)| Pu(0.0026)| CaH(0.0026)| GPeC(0.0)| GPeR(0.0)| PuC(0.0)| PuR(0.0)| SN-VTA(0.0)	Balanced	0	0	0	0	0	0.0989	0.0753	8351	54801	6.56
AIT117_137	IN_137		AIT117_336	BN MEIS2 GABA	cluster							90	3	['C1QL1', 'NPY', 'PLEKHH2']	['CALCR', 'C1QL1', 'NPY', 'CBLN4', 'COL5A2', 'PLEKHH2', 'MIR31HG', 'NPFFR2', 'ZNF124', 'SIX3']	H23.30.001(0.7333)| H20.30.001(0.1444)| H20.30.002(0.1111)| H18.30.001(0.0111)| H19.30.004(0.0)	Balanced	Balanced	2018_C01 (0.1889)|2012_B05 (0.1444)|2012_A05 (0.1222)|1482_A03 (0.0778)|2013_A01 (0.0778)|1036_C03 (0.0778)|1042_C06 (0.0667)|2006_B05 (0.0556)|2016_B03 (0.0444)|2016_A03 (0.0444)|1042_A06 (0.0333)|2016_C03 (0.0222)|2013_B01 (0.0222)|2018_E01 (0.0111)|988_D05 (0.0111)	0.1889	2018_C01 (0.1889)|a total of 7029 cells in this dominant library	GPe(0.4444)| GPi(0.2889)| NAC(0.1778)| PuC(0.0444)| PuPV(0.0222)| CaT(0.0222)| CaH(0.0)| GPeR(0.0)| GPeC(0.0)| CaB(0.0)| Pu(0.0)| PuR(0.0)| SN(0.0)| SN-VTA(0.0)| STH(0.0)	Balanced	0	0	0.24	0.24	0.24	0.14	0.0828	7951.5	49935	6.28
AIT117_138	IN_138		AIT117_336	BN MEIS2 GABA	cluster							66	4	['PLEKHH2', 'AL353604.1', 'CACNG5', 'AL592156.2']	['DNAH8', 'PLEKHH2', 'AL353604.1', 'CACNG5', 'AL592156.2', 'KCNH8', 'GLRA3', 'CFAP47', 'GABRG1', 'PCDH11Y']	H23.30.001(0.7727)| H20.30.001(0.1212)| H20.30.002(0.0909)| H18.30.001(0.0152)| H19.30.004(0.0)	Balanced	Balanced	2018_C01 (0.3182)|2012_B05 (0.2121)|1482_A03 (0.1061)|2013_A01 (0.0606)|2016_A03 (0.0606)|2006_B05 (0.0606)|1036_C03 (0.0455)|2012_A05 (0.0303)|988_C05 (0.0152)|2018_D01 (0.0152)|2013_B01 (0.0152)|988_D05 (0.0152)|930_B05 (0.0152)|822_B01 (0.0152)|994_C03 (0.0152)	0.3182	2018_C01 (0.3182)|a total of 7029 cells in this dominant library	GPe(0.4697)| GPi(0.4242)| NAC(0.0455)| CaT(0.0303)| PuC(0.0152)| PuPV(0.0152)| CaH(0.0)| GPeR(0.0)| GPeC(0.0)| CaB(0.0)| Pu(0.0)| PuR(0.0)| SN(0.0)| SN-VTA(0.0)| STH(0.0)	Balanced	0	0	0	0.12	0.12	0.087	0.0626	6391.5	28398	4.44
AIT117_145	IN_145		AIT117_336	BN MEIS2 GABA	cluster							177	4	['CD36', 'SCN5A', 'PTH2R', 'SLC17A6']	['CD36', 'SCN5A', 'PTH2R', 'AP000829.1', 'CNGB1', 'SLC17A6', 'CCDC144NL-AS1', 'AC110023.1', 'SLC22A10', 'PTPRQ']	H20.30.001(0.6215)| H23.30.001(0.2373)| H20.30.002(0.1412)| H18.30.001(0.0)| H19.30.004(0.0)	Balanced	Balanced	1482_A03 (0.6215)|988_C05 (0.1356)|2013_B01 (0.0791)|2012_B05 (0.0734)|2016_A03 (0.0734)	0.6215	1482_A03 (0.6215)|a total of 4968 cells in this dominant library	GPi(0.8475)| CaT(0.1356)| Pu(0.0056)| SN(0.0056)| STH(0.0056)| CaH(0.0)| CaB(0.0)| GPeR(0.0)| GPeC(0.0)| GPe(0.0)| NAC(0.0)| PuPV(0.0)| PuC(0.0)| PuR(0.0)| SN-VTA(0.0)	Balanced	0	0.24	0	0	0	0.1286	0.115	8017	50914	6.35
AIT117_154	IN_154		AIT117_337	STR SST ADARB2 GABA	cluster							109	2	['AC097512.1', 'WNT5A']	['AC097512.1', 'CALCR', 'WNT5A', 'QRFPR', 'AC093607.1', 'AC097467.3', 'NR2E1', 'RCAN3', 'LINC01776', 'EPHA3']	H20.30.001(0.4312)| H23.30.001(0.4037)| H20.30.002(0.1651)| H18.30.001(0.0)| H19.30.004(0.0)	Balanced	Balanced	1482_A03 (0.4220)|2012_B05 (0.1835)|2016_A03 (0.1835)|988_C05 (0.1651)|2013_B01 (0.0275)	0.422	1482_A03 (0.422)|a total of 4968 cells in this dominant library	GPi(0.8165)| CaT(0.1651)| CaB(0.0092)| NAC(0.0092)| CaH(0.0)| GPeC(0.0)| GPe(0.0)| GPeR(0.0)| Pu(0.0)| PuC(0.0)| PuPV(0.0)| PuR(0.0)| SN(0.0)| SN-VTA(0.0)| STH(0.0)	Balanced	0	0.39	0	0	0.24	0.0882	0.1425	7986	49382	6.18
AIT117_155	IN_155		AIT117_323	NDB SI LHX6 LHX8 GBX1	cluster							137	2	['AC096570.1', 'RASGRP3']	['CORIN', 'TAFA4', 'AC096570.1', 'CASZ1', 'LINC02232', 'RASGRP3', 'CCBE1', 'STAC', 'NDST4', 'TCERG1L']	H23.30.001(0.7007)| H20.30.001(0.2993)| H18.30.001(0.0)| H19.30.004(0.0)| H20.30.002(0.0)	Balanced	Balanced	994_C03 (0.2701)|2016_C03 (0.2555)|2018_D01 (0.2263)|2016_A03 (0.0657)|2012_B05 (0.0511)|2012_A05 (0.0292)|1482_A03 (0.0219)|2006_B05 (0.0219)|2013_A01 (0.0219)|2018_C01 (0.0146)|2013_B01 (0.0146)	0.2701	994_C03 (0.2701)|a total of 4714 cells in this dominant library	GPi(0.6496)| PuPV(0.2555)| GPe(0.0876)| GPeR(0.0073)| CaT(0.0)| CaB(0.0)| CaH(0.0)| GPeC(0.0)| NAC(0.0)| Pu(0.0)| PuC(0.0)| PuR(0.0)| SN(0.0)| SN-VTA(0.0)| STH(0.0)	Balanced	0	0	0	0	0	0.14	0.0724	2714	5463	2.01
AIT117_156	IN_156		AIT117_323	NDB SI LHX6 LHX8 GBX1	cluster							77	3	['FBN2', 'STAC', 'OBI1-AS1']	['AL162493.1', 'CORIN', 'AC096570.1', 'FBN2', 'STAC', 'OBI1-AS1', 'HPSE2', 'TCERG1L', 'FAM189A2', 'LTBP1']	H20.30.001(0.9481)| H23.30.001(0.0519)| H18.30.001(0.0)| H19.30.004(0.0)| H20.30.002(0.0)	Cautious	Balanced	994_C03 (0.9481)|2012_B05 (0.0260)|2016_A03 (0.0260)	0.9481	994_C03 (0.9481)|a total of 4714 cells in this dominant library	GPi(1.0)| CaH(0.0)| CaB(0.0)| CaT(0.0)| GPe(0.0)| GPeC(0.0)| GPeR(0.0)| NAC(0.0)| Pu(0.0)| PuC(0.0)| PuPV(0.0)| PuR(0.0)| SN(0.0)| SN-VTA(0.0)| STH(0.0)	Cautious	0	0.5	0	0.5	0.5	0.18	0.0429	2636	5351	2.03
AIT117_7_1_1	MSN_7_1_1		AIT117_338	STRd D2 Matrix	cluster							5906	4	['LINC01117', 'DRD2', 'PENK', 'CRYM']	['GPR6', 'ADORA2A', 'LINC01117', 'DRD2', 'PENK', 'CRYM', 'NNAT', 'COCH', 'GDA', 'OPRM1']	H20.30.002(0.3739)| H23.30.001(0.2624)| H20.30.001(0.2465)| H18.30.001(0.1172)| H19.30.004(0.0)	Balanced	Balanced	1036_A03 (0.1671)|1036_B03 (0.1235)|1955_B06 (0.0969)|1036_C03 (0.0953)|1091_A05 (0.0847)|1042_A06 (0.0760)|1955_C06 (0.0677)|1042_B06 (0.0667)|1042_C06 (0.0508)|1959_A02 (0.0452)|1959_C02 (0.0388)|822_A01 (0.0181)|930_A05 (0.0171)|847_B04 (0.0132)|847_A04 (0.0103)	0.1671	1036_A03 (0.1671)|a total of 10559 cells in this dominant library	NAC(0.7169)| CaH(0.1328)| Pu(0.1065)| PuR(0.0316)| CaB(0.0055)| GPe(0.0033)| GPeR(0.0012)| PuC(0.0007)| GPeC(0.0005)| PuPV(0.0004)| GPi(0.0004)| CaT(0.0003)| SN(0.0)| SN-VTA(0.0)| STH(0.0)	Balanced	0	0	0	0	0.24	0.02	0.1509	6062	22692	3.74
AIT117_7_1_2	MSN_7_1_2		AIT117_339	STRv D2 Shell	cluster							9164																					
AIT117_7_2	MSN_7_2		AIT117_339	STRv D2 Shell	cluster							565																					
AIT117_7_3	MSN_7_3		AIT117_339	STRv D2 Shell	cluster							1726																					
AIT117_7_4	MSN_7_4		AIT117_339	STRv D2 Shell	cluster							1888																					
AIT117_157	MSN_8		AIT117_340	STRv D1 Shell	cluster							1822	4	['MIR924HG', 'AL136441.1', 'PDYN', 'CCK']	['ENTHD1', 'MIR924HG', 'AL136441.1', 'PDYN', 'CCK', 'AL591501.1', 'OCA2', 'NRP1', 'AC013287.1', 'VSTM2B']	H20.30.002(0.6817)| H20.30.001(0.1345)| H23.30.001(0.1076)| H18.30.001(0.0763)| H19.30.004(0.0)	Balanced	Balanced	1042_A06 (0.2558)|1036_C03 (0.2338)|1036_A03 (0.1674)|1959_A02 (0.0620)|1091_A05 (0.0532)|1036_B03 (0.0516)|1042_B06 (0.0499)|1042_C06 (0.0324)|1959_C02 (0.0159)|930_A05 (0.0159)|1110_B07 (0.0132)|1955_B06 (0.0126)|1955_C06 (0.0104)	0.2558	1042_A06 (0.2558)|a total of 6282 cells in this dominant library	NAC(0.9265)| CaH(0.0291)| Pu(0.0263)| PuR(0.0099)| GPe(0.0038)| PuPV(0.0011)| CaT(0.0011)| PuC(0.0005)| GPi(0.0005)| GPeR(0.0005)| CaB(0.0005)| GPeC(0.0)| SN(0.0)| SN-VTA(0.0)| STH(0.0)	Balanced	0	0	0	0	0.24	0.02	0.1519	6803.5	30279.5	4.45
AIT117_9_1	MSN_9_1		AIT117_341	STRd D1 Matrix	cluster							7349	4	['AGBL1', 'LINC01951', 'PRLR', 'AP003464.1']	['PDYN', 'AGBL1', 'DRD1', 'LINC01951', 'PRLR', 'AP003464.1', 'TAC1', 'CRYM', 'COCH', 'AC013287.1']	H23.30.001(0.3516)| H20.30.002(0.3082)| H20.30.001(0.2391)| H18.30.001(0.1011)| H19.30.004(0.0)	Balanced	Balanced	1036_A03 (0.2328)|1036_B03 (0.1802)|1955_B06 (0.1686)|1955_C06 (0.1184)|1091_A05 (0.0771)|1959_A02 (0.0445)|1042_C06 (0.0370)|1036_C03 (0.0326)|930_A05 (0.0222)|1042_B06 (0.0168)|1959_C02 (0.0143)|1042_A06 (0.0114)	0.2328	1036_A03 (0.2328)|a total of 10559 cells in this dominant library	NAC(0.6395)| CaH(0.2068)| Pu(0.1327)| PuR(0.0164)| CaB(0.0025)| GPe(0.0019)| GPeR(0.0001)| PuC(0.0001)| GPi(0.0)| CaT(0.0)| GPeC(0.0)| PuPV(0.0)| SN(0.0)| SN-VTA(0.0)| STH(0.0)	Balanced	0	0	0	0	0	0.02	0.1544	5956	21395	3.59
AIT117_9_2	MSN_9_2		AIT117_341	STRd D1 Matrix	cluster							3453																					
AIT117_9_3	MSN_9_3		AIT117_342	STRd D1 Striosome	cluster							634																					
AIT117_158	MSN_10		AIT117_340	STRv D1 Shell	cluster							2107	3	['AL136441.1', 'PDYN', 'NDN']	['AC008786.1', 'AC005064.1', 'AL136441.1', 'PDYN', 'NDN', 'SMCO4', 'LINC00534', 'CCK', 'AGBL1', 'GDNF-AS1']	H20.30.001(0.4143)| H20.30.002(0.3968)| H18.30.001(0.1315)| H23.30.001(0.0574)| H19.30.004(0.0)	Balanced	Balanced	1042_B06 (0.3341)|1042_A06 (0.1856)|1036_A03 (0.1163)|1091_A05 (0.1144)|1036_C03 (0.0949)|1959_A02 (0.0532)|1042_C06 (0.0408)|1036_B03 (0.0389)|1110_B07 (0.0128)	0.3341	1042_B06 (0.3341)|a total of 5839 cells in this dominant library	NAC(0.9929)| CaH(0.0052)| CaB(0.0014)| CaT(0.0005)| GPe(0.0)| GPeR(0.0)| GPeC(0.0)| GPi(0.0)| Pu(0.0)| PuC(0.0)| PuPV(0.0)| PuR(0.0)| SN(0.0)| SN-VTA(0.0)| STH(0.0)	Cautious	0	0	0	0	0.5	0.02	0.1476	7678	38569	5.02
AIT117_159	MSN_11		AIT117_340	STRv D1 Shell	cluster							1445	6	['GDNF-AS1', 'PTPRQ', 'STAC', 'LINC01951', 'SEMA3E', 'ADAMTS9-AS2']	['GDNF-AS1', 'PTPRQ', 'STAC', 'LINC01951', 'SEMA3E', 'ADAMTS9-AS2', 'AC008574.1', 'SH3RF2', 'RELN', 'AC008415.1']	H20.30.001(0.436)| H18.30.001(0.2498)| H20.30.002(0.1737)| H23.30.001(0.1405)| H19.30.004(0.0)	Balanced	Balanced	1042_B06 (0.2581)|1091_A05 (0.2457)|1959_A02 (0.1093)|1042_C06 (0.0941)|1036_B03 (0.0837)|1042_A06 (0.0830)|1036_C03 (0.0457)|1036_A03 (0.0429)|1955_B06 (0.0166)	0.2581	1042_B06 (0.2581)|a total of 5839 cells in this dominant library	NAC(0.9661)| CaH(0.0194)| Pu(0.0125)| CaB(0.0014)| PuC(0.0007)| GPe(0.0)| CaT(0.0)| GPi(0.0)| GPeR(0.0)| GPeC(0.0)| PuPV(0.0)| PuR(0.0)| SN(0.0)| SN-VTA(0.0)| STH(0.0)	Cautious	0	0	0	0	0.5	0.0152	0.0765	7174	33386	4.65
AIT117_160	MSN_12		AIT117_340	STRv D1 Shell	cluster							2748	4	['WFS1', 'AC015631.1', 'LINC02462', 'AGBL1']	['WFS1', 'AL359220.1', 'AC015631.1', 'LINC02462', 'AGBL1', 'LINC01117', 'EBF1', 'LINC01951', 'TAC1', 'AL591501.1']	H20.30.002(0.4585)| H20.30.001(0.4298)| H23.30.001(0.0695)| H18.30.001(0.0422)| H19.30.004(0.0)	Balanced	Balanced	1036_C03 (0.4079)|1042_C06 (0.2635)|1042_B06 (0.1270)|1042_A06 (0.0433)|1036_B03 (0.0317)|2006_B05 (0.0233)|1110_B07 (0.0186)|1091_A05 (0.0156)|2013_A01 (0.0149)|1959_B02 (0.0149)|1959_A02 (0.0113)	0.4079	1036_C03 (0.4079)|a total of 10219 cells in this dominant library	NAC(0.9276)| GPe(0.0389)| CaH(0.0175)| CaB(0.0069)| GPeR(0.0055)| Pu(0.0018)| PuPV(0.0007)| PuR(0.0004)| PuC(0.0004)| GPi(0.0004)| CaT(0.0)| GPeC(0.0)| SN(0.0)| SN-VTA(0.0)| STH(0.0)	Balanced	0	0	0	0	0.5	0.027	0.143	7216	34021.5	4.71
AIT117_161	MSN_13		AIT117_342	STRd D1 Striosome	cluster							1644	5	['PDYN', 'OPN4', 'SLC7A2', 'AL356295.1', 'SERPINI2']	['PDYN', 'OPN4', 'SLC7A2', 'AL356295.1', 'SERPINI2', 'AC073365.1', 'MCTP2', 'PTPRQ', 'FKBP5', 'LINC01902']	H20.30.001(0.4209)| H23.30.001(0.2354)| H20.30.002(0.1727)| H18.30.001(0.1709)| H19.30.004(0.0)	Balanced	Balanced	1036_B03 (0.2573)|1091_A05 (0.1350)|1036_A03 (0.1156)|1042_C06 (0.0955)|1955_B06 (0.0876)|1959_A02 (0.0627)|1042_B06 (0.0505)|1959_C02 (0.0347)|1042_A06 (0.0249)|847_A04 (0.0225)|1955_C06 (0.0182)|930_C05 (0.0176)|930_A05 (0.0176)|1959_B02 (0.0158)|1036_C03 (0.0116)	0.2573	1036_B03 (0.2573)|a total of 8553 cells in this dominant library	NAC(0.7591)| CaH(0.1612)| Pu(0.0529)| PuR(0.0097)| GPe(0.0085)| CaB(0.0079)| GPi(0.0006)| GPeR(0.0)| GPeC(0.0)| CaT(0.0)| PuC(0.0)| PuPV(0.0)| SN(0.0)| SN-VTA(0.0)| STH(0.0)	MSN_14	D1-MSN	D1-Striosome				CNU-LGE GABA	CNU-LGE GABA(1.0)	962 STR D1 Gaba_8(0.61) | 0964 STR D1 Gaba_9(0.3)	ACB(0.64) | ACB an(0.31)	ACB (nucleus accumbens) belnogs to ventral striatum 
AIT117_162	MSN_14		AIT117_342	STRd D1 Striosome	cluster							607	4	['MIR924HG', 'PDYN', 'SEMA3C', 'PTPRQ']	['AC138646.1', 'MIR924HG', 'AC069410.1', 'PDYN', 'SEMA3C', 'PTPRQ', 'COL24A1', 'NNAT', 'LINC01902', 'AC013287.1']	H20.30.002(0.6425)| H23.30.001(0.1499)| H18.30.001(0.1269)| H20.30.001(0.0807)| H19.30.004(0.0)	Balanced	Balanced	1036_C03 (0.3575)|1042_A06 (0.1252)|1036_A03 (0.1038)|1091_A05 (0.0807)|1959_C02 (0.0774)|1042_C06 (0.0478)|1959_A02 (0.0461)|822_A01 (0.0297)|1036_B03 (0.0264)|930_A05 (0.0247)|1110_B07 (0.0148)|1955_C06 (0.0132)|1110_A07 (0.0115)	0.3575	1036_C03 (0.3575)|a total of 10219 cells in this dominant library	NAC(0.8204)| Pu(0.0906)| CaH(0.0379)| PuR(0.0362)| PuPV(0.0049)| CaB(0.0033)| GPe(0.0033)| GPeC(0.0016)| CaT(0.0016)| GPi(0.0)| GPeR(0.0)| PuC(0.0)| SN(0.0)| SN-VTA(0.0)| STH(0.0)	MSN_15	D1-MSN	D1-Striosome				CNU-LGE GABA	CNU-LGE GABA(1.0)	962 STR D1 Gaba_8(0.55) | 0964 STR D1 Gaba_9(0.25)	ACB(0.61) | ACB an(0.26)	
AIT117_163	MSN_15		AIT117_342	STRd D1 Striosome	cluster							3009	3	['AC096719.1', 'AC069410.1', 'PDYN']	['AC096719.1', 'AC092979.1', 'AC069410.1', 'CCDC196', 'PDYN', 'SEMA3D', 'LINC01435', 'SERPINI2', 'PTPRQ', 'TAC1']	H23.30.001(0.4317)| H20.30.002(0.2868)| H18.30.001(0.1519)| H20.30.001(0.1296)| H19.30.004(0.0)	Balanced	Balanced	822_A01 (0.1781)|1955_C06 (0.1353)|1959_C02 (0.0954)|1955_B06 (0.0798)|847_A04 (0.0721)|847_B04 (0.0472)|1036_A03 (0.0465)|930_C05 (0.0389)|930_E05 (0.0329)|1036_B03 (0.0309)|1959_B02 (0.0306)|897_E03 (0.0292)|2006_A05 (0.0289)|930_A05 (0.0239)|2006_B05 (0.0193)|1091_A05 (0.0153)|2013_C01 (0.0143)|1959_A02 (0.0133)	0.1781	822_A01 (0.1781)|a total of 10559 cells in this dominant library	CaH(0.2453)| Pu(0.2306)| PuR(0.2303)| NAC(0.1303)| CaB(0.1147)| GPe(0.0206)| PuC(0.0136)| PuPV(0.012)| CaT(0.002)| GPeC(0.0003)| GPeR(0.0003)| GPi(0.0)| SN(0.0)| SN-VTA(0.0)| STH(0.0)	MSN_16	D1-MSN	D1-Striosome				CNU-LGE GABA	CNU-LGE GABA(1.0)	965 STR D1 Gaba_9(0.3) | 0954 STR D1 Gaba_4(0.25) | 0961 STR D1 Gaba_8(0.17)	STRd(0.44) | ACB an(0.32) | ACB(0.18)	
AIT117_164	MSN_16		AIT117_342	STRd D1 Striosome	cluster							2106	6	['AC008786.1', 'PDYN', 'AC073365.1', 'FER1L6-AS2', 'AL445584.2', 'TAC1']	['AC008786.1', 'PDYN', 'AC073365.1', 'FER1L6-AS2', 'AL445584.2', 'TAC1', 'TRPC6', 'AC092691.3', 'RELN', 'THSD7B']	H23.30.001(0.377)| H18.30.001(0.2811)| H20.30.001(0.2678)| H20.30.002(0.0741)| H19.30.004(0.0)	Balanced	Balanced	847_A04 (0.2312)|930_C05 (0.1268)|2006_A05 (0.1178)|930_E05 (0.1083)|1959_B02 (0.1030)|2013_C01 (0.0522)|822_A01 (0.0361)|891_A06 (0.0337)|2006_B05 (0.0294)|1959_C02 (0.0214)|1955_B06 (0.0209)|930_A05 (0.0171)|1036_B03 (0.0152)|1042_C06 (0.0152)|897_E03 (0.0142)|2013_A01 (0.0133)|847_B04 (0.0114)	0.2312	847_A04 (0.2312)|a total of 9215 cells in this dominant library	CaH(0.4991)| CaB(0.3262)| PuR(0.0475)| NAC(0.0446)| GPe(0.0432)| Pu(0.0242)| CaT(0.0076)| PuPV(0.0062)| PuC(0.0014)| GPeC(0.0)| GPeR(0.0)| GPi(0.0)| SN(0.0)| SN-VTA(0.0)| STH(0.0)	MSN_17	D1-MSN	D1-Striosome				CNU-LGE GABA	CNU-LGE GABA(1.0)	962 STR D1 Gaba_8(0.44) | 0954 STR D1 Gaba_4(0.3) | 0950 STR D1 Gaba_3(0.13)	ACB(0.47) | STRd(0.45)	
AIT117_165	MSN_17		AIT117_343	STRd D2 Striosome	cluster							93	4	['DRD2', 'LOXHD1', 'AC011246.1', 'THSD7B']	['OPRD1', 'DRD2', 'LOXHD1', 'TRPC6', 'AC011246.1', 'THSD7B', 'SYT12', 'RELN', 'OPRM1', 'AC008415.1']	H23.30.001(0.8065)| H20.30.001(0.129)| H18.30.001(0.0538)| H20.30.002(0.0108)| H19.30.004(0.0)	Balanced	Balanced	2006_B05 (0.7312)|930_E05 (0.0430)|2006_A05 (0.0323)|1042_B06 (0.0323)|2013_A01 (0.0215)|930_C05 (0.0215)|847_A04 (0.0215)|1042_C06 (0.0215)|1959_B02 (0.0108)|853_B07 (0.0108)|891_A06 (0.0108)|1110_B07 (0.0108)|2013_C01 (0.0108)|822_B01 (0.0108)|988_E05 (0.0108)	0.7312	2006_B05 (0.7312)|a total of 6534 cells in this dominant library	GPe(0.7527)| CaB(0.0968)| NAC(0.0645)| CaH(0.0538)| PuPV(0.0215)| GPeC(0.0108)| CaT(0.0)| GPi(0.0)| GPeR(0.0)| Pu(0.0)| PuC(0.0)| PuR(0.0)| SN(0.0)| SN-VTA(0.0)| STH(0.0)	MSN_18	D2-MSN	D2-Striosome		close to D2-Matrix and D2-Striosome (more)	MSN	CNU-LGE GABA	CNU-LGE GABA(1.0)	978 STR D2 Gaba_2(0.66) | 0981 STR D2 Gaba_4(0.19)	CP po(0.6) | STRd(0.2)	CP(caudoputamen) belongs to dorsal striatum
AIT117_166	MSN_18		AIT117_342	STRd D1 Striosome	cluster							185	5	['AC073365.1', 'AL445584.2', 'LINC01951', 'TRPC6', 'LOXHD1']	['AC073365.1', 'FER1L6-AS2', 'AL445584.2', 'LINC01951', 'TRPC6', 'LOXHD1', 'AC011246.1', 'KIAA2012', 'LZTS1', 'RELN']	H23.30.001(0.7946)| H20.30.001(0.1351)| H20.30.002(0.0486)| H18.30.001(0.0216)| H19.30.004(0.0)	Balanced	Balanced	2006_B05 (0.6270)|2006_A05 (0.0811)|930_E05 (0.0324)|1042_C06 (0.0324)|1042_B06 (0.0324)|1036_C03 (0.0270)|1036_B03 (0.0216)|1036_A03 (0.0162)|930_C05 (0.0162)|1955_B06 (0.0162)|1959_B02 (0.0162)|2018_E01 (0.0108)|2013_A01 (0.0108)|2013_C01 (0.0108)	0.627	2006_B05 (0.627)|a total of 6534 cells in this dominant library	GPe(0.6378)| NAC(0.1405)| CaB(0.1297)| CaH(0.0541)| CaT(0.0162)| Pu(0.0108)| GPi(0.0054)| PuPV(0.0054)| GPeC(0.0)| GPeR(0.0)| PuC(0.0)| PuR(0.0)| SN(0.0)| SN-VTA(0.0)| STH(0.0)	MSN_19	D1-MSN	D1-Striosome		close to D1-Striosome	MSN	CNU-LGE GABA	CNU-LGE GABA(1.0)	962 STR D1 Gaba_8(0.51) | 0954 STR D1 Gaba_4(0.23) | 0964 STR D1 Gaba_9(0.1)	ACB(0.56) | STRd(0.28)	
AIT117_167	MSN_19		AIT117_343	STRd D2 Striosome	cluster							479	4	['LINC02046', 'AC096719.1', 'AC069410.1', 'SLC7A2']	['LINC02046', 'CPB1', 'AC096719.1', 'AC092979.1', 'AC069410.1', 'SLC7A2', 'SEMA3D', 'AL353604.1', 'AL356295.1', 'AL139379.1']	H20.30.001(0.3591)| H23.30.001(0.3361)| H18.30.001(0.2484)| H20.30.002(0.0564)| H19.30.004(0.0)	Balanced	Balanced	1091_A05 (0.1524)|930_C05 (0.1294)|1959_C02 (0.1127)|1036_B03 (0.0856)|847_A04 (0.0752)|1959_A02 (0.0710)|930_E05 (0.0626)|1959_B02 (0.0626)|1042_C06 (0.0522)|2006_A05 (0.0251)|1955_B06 (0.0251)|1042_B06 (0.0230)|1036_C03 (0.0230)|2013_C01 (0.0167)|847_B04 (0.0146)|897_E03 (0.0125)|930_A05 (0.0104)	0.1524	1091_A05 (0.1524)|a total of 6113 cells in this dominant library	NAC(0.4217)| CaH(0.3027)| Pu(0.119)| CaB(0.1169)| PuR(0.0167)| PuPV(0.0104)| GPe(0.0063)| CaT(0.0042)| PuC(0.0021)| GPeC(0.0)| GPeR(0.0)| GPi(0.0)| SN(0.0)| SN-VTA(0.0)| STH(0.0)	MSN_20	D2-MSN	D2-Striosome				CNU-LGE GABA	CNU-LGE GABA(1.0)	978 STR D2 Gaba_2(0.67) | 0979 STR D2 Gaba_4(0.17)	ACB(0.75) | STRv(0.25)	
AIT117_20	MSN_20		AIT117_343	STRd D2 Striosome	cluster							2205	3	['ADORA2A', 'PTPRQ', 'AL138701.2']	['AL353604.1', 'SLC7A2', 'GPR6', 'ADORA2A', 'PTPRQ', 'AL138701.2', 'DRD2', 'PENK', 'AC011246.1', 'OCA2']	H20.30.002(0.478)| H23.30.001(0.2594)| H20.30.001(0.1891)| H18.30.001(0.0735)| H19.30.004(0.0)	Balanced	Balanced	1036_A03 (0.2209)|1036_C03 (0.1283)|1036_B03 (0.1066)|1955_C06 (0.0930)|1955_B06 (0.0576)|930_A05 (0.0558)|1042_C06 (0.0544)|822_A01 (0.0440)|1959_C02 (0.0426)|1091_A05 (0.0304)|1042_A06 (0.0272)|847_A04 (0.0254)|1959_B02 (0.0209)|1042_B06 (0.0200)|1959_A02 (0.0186)|2006_B05 (0.0113)	0.2209	1036_A03 (0.2209)|a total of 10559 cells in this dominant library	NAC(0.6136)| CaH(0.1669)| Pu(0.1356)| PuR(0.054)| CaB(0.0141)| GPe(0.0132)| PuC(0.0014)| PuPV(0.0005)| CaT(0.0005)| GPeC(0.0005)| GPeR(0.0)| GPi(0.0)| SN(0.0)| SN-VTA(0.0)| STH(0.0)	MSN_21	D2-MSN	D2-Striosome				CNU-LGE GABA	CNU-LGE GABA(1.0)	978 STR D2 Gaba_2(0.83)	ACB(0.78) | STRv(0.05)	
AIT117_21	MSN_21		AIT117_343	STRd D2 Striosome	cluster							400	5	['AC076968.2', 'PTPRQ', 'AC010997.3', 'THSD7B', 'RBM20']	['AC076968.2', 'PTPRQ', 'AC010997.3', 'THSD7B', 'FGFR2', 'RBM20', 'OPRM1', 'KCNK2', 'GRIK3', 'RASGRP1']	H20.30.002(0.7875)| H20.30.001(0.1275)| H18.30.001(0.0775)| H23.30.001(0.0075)| H19.30.004(0.0)	Balanced	Balanced	1042_A06 (0.5850)|1036_C03 (0.1450)|1042_C06 (0.0575)|1042_B06 (0.0550)|1110_B07 (0.0425)|930_A05 (0.0250)|822_A01 (0.0225)|1091_A05 (0.0175)|1110_A07 (0.0150)|1036_B03 (0.0150)	0.585	1042_A06 (0.585)|a total of 6282 cells in this dominant library	NAC(0.9425)| CaH(0.025)| PuR(0.0225)| GPi(0.0025)| PuC(0.0025)| CaT(0.0025)| GPe(0.0025)| GPeR(0.0)| GPeC(0.0)| CaB(0.0)| Pu(0.0)| PuPV(0.0)| SN(0.0)| SN-VTA(0.0)| STH(0.0)	MSN_22	D2-MSN	D2-Striosome		D2-Striosome	MSN	CNU-LGE GABA	CNU-LGE GABA(1.0)	978 STR D2 Gaba_2(0.94)	CP po ve(0.47) | CP po(0.27) | ACB(0.27)	
AIT117_22	MSN_22		AIT117_343	STRd D2 Striosome	cluster							699	3	['AC069410.1', 'ADORA2A', 'PTPRQ']	['AC069410.1', 'GPR6', 'AL353604.1', 'ADORA2A', 'SLC38A11', 'PTPRQ', 'DRD2', 'CORO6', 'CA12', 'AC011246.1']	H23.30.001(0.7568)| H20.30.002(0.1159)| H18.30.001(0.0658)| H20.30.001(0.0615)| H19.30.004(0.0)	Balanced	Balanced	1955_C06 (0.2947)|1955_B06 (0.2132)|1959_C02 (0.1073)|822_A01 (0.0415)|1036_B03 (0.0401)|1036_A03 (0.0401)|2006_B05 (0.0386)|2006_A05 (0.0358)|847_B04 (0.0300)|1959_B02 (0.0243)|1036_C03 (0.0215)|1091_A05 (0.0143)|847_A04 (0.0129)|2016_C03 (0.0114)	0.2947	1955_C06 (0.2947)|a total of 8987 cells in this dominant library	Pu(0.402)| CaH(0.2546)| NAC(0.1474)| PuR(0.0758)| CaB(0.0486)| GPe(0.0415)| PuPV(0.0172)| PuC(0.0086)| CaT(0.0043)| GPeC(0.0)| GPeR(0.0)| GPi(0.0)| SN(0.0)| SN-VTA(0.0)| STH(0.0)	MSN_23	D2-MSN	D2-Striosome				CNU-LGE GABA	CNU-LGE GABA(1.0)	978 STR D2 Gaba_2(0.56) | 0981 STR D2 Gaba_4(0.25)	ACB(0.27) | ACB an(0.18) | CP po ve(0.18)	
AIT117_168	MSN_23		AIT117_343	STRd D2 Striosome	cluster							511	4	['ACOXL', 'LGR6', 'SLC38A11', 'CLMP']	['ACOXL', 'LGR6', 'SEC16B', 'GPC4', 'SLC38A11', 'CLMP', 'SLC22A10', 'LOXHD1', 'FKBP5', 'ARHGAP10']	H20.30.001(0.7123)| H20.30.002(0.1057)| H18.30.001(0.1018)| H23.30.001(0.0802)| H19.30.004(0.0)	Balanced	Balanced	930_D05 (0.2896)|930_F05 (0.2055)|988_E05 (0.1840)|988_C05 (0.0411)|847_C04 (0.0391)|847_D04 (0.0294)|822_A01 (0.0235)|822_B01 (0.0235)|930_C05 (0.0235)|2016_B03 (0.0215)|847_B04 (0.0196)|2018_A01 (0.0176)|2018_B01 (0.0117)|2016_C03 (0.0117)|930_B05 (0.0117)	0.2896	930_D05 (0.2896)|a total of 8788 cells in this dominant library	PuC(0.3699)| PuPV(0.2701)| PuR(0.2485)| CaT(0.0489)| CaH(0.0254)| CaB(0.0215)| NAC(0.0078)| Pu(0.0059)| GPe(0.002)| GPeC(0.0)| GPeR(0.0)| GPi(0.0)| SN(0.0)| SN-VTA(0.0)| STH(0.0)	MSN_24	D2-MSN	D2-Striosome				CNU-LGE GABA	CNU-LGE GABA(1.0)	982 STR D2 Gaba_4(0.48) | 0979 STR D2 Gaba_4(0.28) | 0977 STR D2 Gaba_2(0.24)	widespread(nan) | ???(nan) | AAA(nan)	
AIT117_169	MSN_24		AIT117_343	STRd D2 Striosome	cluster							263	3	['AL138720.1', 'LGR5', 'ATP10A']	['M1AP', 'SPATA22', 'ENPEP', 'AL138720.1', 'LGR5', 'ATP10A', 'LINC02197', 'AL033523.1', 'CLMP', 'PTPRQ']	H23.30.001(0.3726)| H20.30.002(0.3536)| H20.30.001(0.1901)| H18.30.001(0.0837)| H19.30.004(0.0)	Balanced	Balanced	822_A01 (0.1141)|1036_A03 (0.0837)|1036_C03 (0.0760)|2016_B03 (0.0684)|1036_B03 (0.0608)|1042_C06 (0.0456)|2018_A01 (0.0456)|2018_B01 (0.0456)|2006_B05 (0.0418)|1042_B06 (0.0418)|1042_A06 (0.0304)|2016_C03 (0.0266)|1091_A05 (0.0266)|1959_C02 (0.0228)|847_C04 (0.0228)|1955_B06 (0.0190)|1955_C06 (0.0190)|930_A05 (0.0190)|1959_A02 (0.0190)|1959_B02 (0.0190)|2013_C01 (0.0152)|2006_A05 (0.0152)|930_D05 (0.0152)|847_D04 (0.0152)|822_B01 (0.0152)|930_C05 (0.0114)|847_A04 (0.0114)	0.1141	822_A01 (0.1141)|a total of 10559 cells in this dominant library	NAC(0.3878)| PuC(0.1521)| PuR(0.1255)| PuPV(0.1179)| CaH(0.0798)| GPe(0.0494)| Pu(0.0418)| CaB(0.0342)| CaT(0.0076)| GPi(0.0038)| GPeC(0.0)| GPeR(0.0)| SN(0.0)| SN-VTA(0.0)| STH(0.0)	MSN_25	D2-MSN	D2-Striosome		middle of D2-Striosome and D2-Hybrid-MCHR3	MSN	CNU-LGE GABA	CNU-LGE GABA(1.0)	978 STR D2 Gaba_2(0.46) | 0979 STR D2 Gaba_4(0.24) | 0981 STR D2 Gaba_4(0.22)	CP po ve(0.9)	CP(caudoputamen) belongs to dorsal striatum
AIT117_170	MSN_25		AIT117_343	STRd D2 Striosome	cluster							100	3	['SLC22A25', 'LINC01735', 'SEC16B']	['SLC22A24', 'SLC22A25', 'SPATA22', 'AL138720.1', 'LINC01735', 'SEC16B', 'LGR5', 'AL353604.1', 'AL033523.1', 'AC068722.1']	H20.30.002(0.77)| H23.30.001(0.13)| H18.30.001(0.09)| H20.30.001(0.01)| H19.30.004(0.0)	Balanced	Balanced	897_E03 (0.6500)|822_A01 (0.0800)|2016_B03 (0.0400)|2006_A05 (0.0300)|822_B01 (0.0300)|1110_A07 (0.0300)|2018_A01 (0.0200)|847_B04 (0.0200)	0.65	897_E03 (0.65)|a total of 6586 cells in this dominant library	CaB(0.7)| PuR(0.1)| PuC(0.08)| PuPV(0.06)| NAC(0.04)| CaH(0.02)| CaT(0.0)| GPi(0.0)| GPeR(0.0)| GPeC(0.0)| GPe(0.0)| Pu(0.0)| SN(0.0)| SN-VTA(0.0)| STH(0.0)	MSN_26	D2-MSN	D2-Striosome				CNU-LGE GABA	CNU-LGE GABA(1.0)	980 STR D2 Gaba_4(0.49) | 0981 STR D2 Gaba_4(0.25) | 0977 STR D2 Gaba_2(0.24)	CP po ve(1.0)	CP(caudoputamen) belongs to dorsal striatum
AIT117_171	MSN_26		AIT117_343	STRd D2 Striosome	cluster							1229	4	['LINC01735', 'LGR5', 'AL353604.1', 'TARID']	['TNFRSF8', 'LINC01735', 'SEC16B', 'LGR5', 'AL353604.1', 'TARID', 'PTPRQ', 'SLC22A10', 'DRD2', 'AC011246.1']	H20.30.002(0.5663)| H23.30.001(0.271)| H18.30.001(0.1196)| H20.30.001(0.0431)| H19.30.004(0.0)	Balanced	Balanced	822_A01 (0.4817)|2016_B03 (0.0643)|2018_A01 (0.0602)|1959_C02 (0.0529)|847_C04 (0.0456)|847_B04 (0.0382)|2018_B01 (0.0350)|930_A05 (0.0301)|847_D04 (0.0203)|1959_B02 (0.0195)|930_D05 (0.0146)|930_F05 (0.0146)|2013_C01 (0.0138)|1036_A03 (0.0130)|897_E03 (0.0106)	0.4817	822_A01 (0.4817)|a total of 10559 cells in this dominant library	PuR(0.5346)| PuC(0.1668)| PuPV(0.0944)| CaH(0.061)| Pu(0.0537)| NAC(0.0456)| CaB(0.0301)| CaT(0.0098)| GPe(0.0033)| GPeC(0.0008)| GPeR(0.0)| GPi(0.0)| SN(0.0)| SN-VTA(0.0)| STH(0.0)	Balanced	0	0	0	0	0	0.02	0.1594	6601	30973	4.69
AIT117_172	MSN_27		AIT117_344	STRd D1D2 Hybrid	cluster							1091	4	['FRMD7', 'LINC02197', 'KCNH8', 'DRD2']	['FRMD7', 'LINC02197', 'HRH3', 'AC022126.1', 'KCNH8', 'DRD2', 'KCNH5', 'ALK', 'CPNE4', 'CCDC39']	H20.30.002(0.3098)| H23.30.001(0.3052)| H18.30.001(0.2172)| H20.30.001(0.1677)| H19.30.004(0.0)	Balanced	Balanced	1036_C03 (0.0962)|1036_A03 (0.0742)|1091_A05 (0.0669)|847_A04 (0.0596)|1042_A06 (0.0587)|1036_B03 (0.0458)|822_A01 (0.0440)|2006_B05 (0.0348)|1042_C06 (0.0348)|1959_A02 (0.0339)|1042_B06 (0.0266)|1959_B02 (0.0257)|2016_B03 (0.0247)|1955_B06 (0.0229)|2006_A05 (0.0220)|1955_C06 (0.0211)|930_C05 (0.0202)|1959_C02 (0.0202)|988_D05 (0.0183)|2018_B01 (0.0183)|847_B04 (0.0174)|1110_B07 (0.0165)|2018_A01 (0.0137)|847_C04 (0.0128)|930_A05 (0.0128)|2013_A01 (0.0119)|897_E03 (0.0110)|2013_C01 (0.0110)|2016_C03 (0.0110)|930_D05 (0.0101)|2018_C01 (0.0101)	0.0962	1036_C03 (0.0962)|a total of 10219 cells in this dominant library	NAC(0.4601)| CaH(0.1412)| PuR(0.0687)| GPe(0.0605)| PuC(0.0587)| PuPV(0.0568)| CaB(0.0541)| Pu(0.0412)| CaT(0.0394)| GPi(0.0082)| GPeR(0.0055)| GPeC(0.0046)| SN(0.0009)| SN-VTA(0.0)| STH(0.0)	Balanced	0	0	0	0	0	0.0267	0.1291	6317	27773	4.4
AIT117_28	MSN_28		AIT117_344	STRd D1D2 Hybrid	cluster							230	4	['TRPC7', 'AC068308.1', 'XIST', 'ZFPM2-AS1']	['TRPC7', 'AC068308.1', 'TSIX', 'SYNPR-AS1', 'XIST', 'ZFPM2-AS1', 'KCNH8', 'NDST4', 'GABRG3-AS1', 'CPNE4']	H18.30.001(0.8435)| H20.30.002(0.0696)| H23.30.001(0.0522)| H20.30.001(0.0348)| H19.30.004(0.0)	Balanced	Balanced	1110_B07 (0.4696)|1110_A07 (0.3652)|1036_B03 (0.0261)|1042_A06 (0.0217)|1036_A03 (0.0174)|1959_C02 (0.0130)|1959_B02 (0.0130)|2006_B05 (0.0130)|897_E03 (0.0130)	0.4696	1110_B07 (0.4696)|a total of 4786 cells in this dominant library	NAC(0.9217)| CaT(0.0174)| CaH(0.0174)| GPe(0.0174)| CaB(0.013)| Pu(0.013)| GPeC(0.0)| GPi(0.0)| GPeR(0.0)| PuC(0.0)| PuPV(0.0)| PuR(0.0)| SN(0.0)| SN-VTA(0.0)| STH(0.0)	Balanced	0	0	0	0	0	0.0323	0.0244	4153	13229.5	3.19
AIT117_173	MSN_29		AIT117_344	STRd D1D2 Hybrid	cluster							2300	4	['AL590867.1', 'CRHR2', 'RXFP1', 'SYT10']	['AL590867.1', 'CRHR2', 'CASZ1', 'AC022126.1', 'RXFP1', 'SYT10', 'KCNH8', 'NDST4', 'CFAP47', 'TRHDE']	H20.30.002(0.3835)| H20.30.001(0.2857)| H23.30.001(0.1909)| H18.30.001(0.14)| H19.30.004(0.0)	Balanced	Balanced	1036_B03 (0.1404)|1036_A03 (0.1400)|1036_C03 (0.1261)|1091_A05 (0.0817)|1042_B06 (0.0787)|1042_A06 (0.0748)|1959_A02 (0.0548)|1042_C06 (0.0457)|1955_B06 (0.0435)|1959_C02 (0.0252)|822_A01 (0.0222)|930_A05 (0.0196)|1110_B07 (0.0196)|1955_C06 (0.0174)|2006_B05 (0.0161)|930_C05 (0.0152)|847_A04 (0.0148)	0.1404	1036_B03 (0.1404)|a total of 8553 cells in this dominant library	NAC(0.7704)| CaH(0.1013)| Pu(0.0426)| PuR(0.0296)| GPe(0.023)| CaT(0.0126)| PuPV(0.01)| CaB(0.007)| GPi(0.0022)| PuC(0.0009)| GPeC(0.0004)| GPeR(0.0)| SN(0.0)| SN-VTA(0.0)| STH(0.0)	Balanced	0	0	0	0	0	0.02	0.1863	6270.5	26717.5	4.26
AIT117_30	MSN_30		AIT117_344	STRd D1D2 Hybrid	cluster							748	2	['VGF', 'TAC1']	['VGF', 'PDYN', 'RXFP1', 'STAC', 'TAC1', 'DRD1', 'ITM2C', 'AC013287.1', 'FOXP2', 'NRGN']	H23.30.001(0.7366)| H20.30.002(0.1684)| H18.30.001(0.0775)| H20.30.001(0.0174)| H19.30.004(0.0)	Balanced	Balanced	1955_C06 (0.4158)|1955_B06 (0.2005)|1959_C02 (0.0775)|1036_C03 (0.0588)|1036_A03 (0.0548)|1091_A05 (0.0361)|822_A01 (0.0321)|1042_A06 (0.0187)|988_D05 (0.0147)|847_B04 (0.0147)|2006_B05 (0.0134)|1959_A02 (0.0107)	0.4158	1955_C06 (0.4158)|a total of 8987 cells in this dominant library	Pu(0.4933)| CaH(0.2179)| NAC(0.1872)| PuR(0.0468)| CaT(0.0187)| GPe(0.0147)| CaB(0.0094)| PuPV(0.008)| PuC(0.0027)| STH(0.0013)| GPeC(0.0)| GPi(0.0)| GPeR(0.0)| SN(0.0)| SN-VTA(0.0)	Balanced	0	0	0	0	0	0.02	0.5731	4279.5	10774	2.52
AIT117_174	MSN_31		AIT117_344	STRd D1D2 Hybrid	cluster							665	4	['AC002383.1', 'CLMP', 'TMEM179', 'GLI3']	['AC002383.1', 'CLMP', 'TMEM179', 'GLI3', 'CACNA1I', 'ZIM2', 'SDK2', 'GRIK1', 'IVNS1ABP', 'KCNT1']	H20.30.001(0.8556)| H23.30.001(0.1098)| H20.30.002(0.0195)| H18.30.001(0.015)| H19.30.004(0.0)	Balanced	Balanced	930_D05 (0.4075)|988_E05 (0.2617)|930_F05 (0.1579)|2016_B03 (0.0466)|2016_C03 (0.0195)|930_E05 (0.0150)|2018_A01 (0.0150)|2018_B01 (0.0150)|930_C05 (0.0120)|822_A01 (0.0120)	0.4075	930_D05 (0.4075)|a total of 8788 cells in this dominant library	PuC(0.4737)| PuPV(0.3053)| PuR(0.1699)| CaB(0.0211)| CaH(0.0135)| Pu(0.0045)| CaT(0.0045)| NAC(0.0045)| GPe(0.003)| GPeC(0.0)| GPeR(0.0)| GPi(0.0)| SN(0.0)| SN-VTA(0.0)| STH(0.0)	Balanced	0	0	0	0	0	0.02	0.1519	6900	34167	4.95
AIT117_175	MSN_32		AIT117_344	STRd D1D2 Hybrid	cluster							429	5	['MIR31HG', 'MIR4500HG', 'GFRA1', 'SHROOM3', 'GLI3']	['MIR31HG', 'STAC', 'MIR4500HG', 'GFRA1', 'SHROOM3', 'GLI3', 'TRHDE', 'GRIK1', 'ARHGAP10', 'NTNG1']	H20.30.002(0.8368)| H23.30.001(0.0932)| H18.30.001(0.0373)| H20.30.001(0.0326)| H19.30.004(0.0)	Balanced	Balanced	897_E03 (0.4289)|988_C05 (0.1352)|822_B01 (0.1282)|930_B05 (0.1096)|822_A01 (0.0233)|988_D05 (0.0186)|2016_B03 (0.0163)|2018_E01 (0.0140)|930_C05 (0.0117)	0.4289	897_E03 (0.4289)|a total of 6586 cells in this dominant library	CaB(0.4499)| CaT(0.1702)| PuPV(0.1492)| PuC(0.1422)| GPe(0.0256)| PuR(0.0233)| CaH(0.0186)| NAC(0.0186)| Pu(0.0023)| GPeC(0.0)| GPeR(0.0)| GPi(0.0)| SN(0.0)| SN-VTA(0.0)| STH(0.0)	Balanced	0	0	0	0	0	0.0357	0.127	5964	33551	5.63
AIT117_33	MSN_33		AIT117_344	STRd D1D2 Hybrid	cluster							2761	3	['LECT2', 'CALCRL', 'STAC']	['LECT2', 'FRK', 'CALCRL', 'RXFP1', 'STAC', 'AC132153.1', 'TAC1', 'GFRA1', 'TRHDE', 'FOXP2']	H23.30.001(0.4133)| H20.30.001(0.2112)| H18.30.001(0.2083)| H20.30.002(0.1673)| H19.30.004(0.0)	Balanced	Balanced	822_A01 (0.1021)|847_A04 (0.1007)|930_C05 (0.0616)|930_E05 (0.0583)|980_C02 (0.0569)|2006_A05 (0.0543)|2018_E01 (0.0525)|2018_B01 (0.0493)|1959_B02 (0.0438)|2013_C01 (0.0417)|2018_A01 (0.0380)|2016_B03 (0.0330)|1959_C02 (0.0235)|891_A06 (0.0228)|847_D04 (0.0214)|988_D05 (0.0206)|2012_C05 (0.0192)|1091_A05 (0.0163)|847_B04 (0.0159)|930_A05 (0.0152)|2016_C03 (0.0145)|1036_A03 (0.0141)|897_E03 (0.0134)|988_E05 (0.0130)|1955_B06 (0.0123)|2006_B05 (0.0120)|1036_B03 (0.0101)	0.1021	822_A01 (0.1021)|a total of 10559 cells in this dominant library	CaH(0.2336)| CaB(0.1905)| CaT(0.1514)| PuR(0.1188)| PuC(0.1)| PuPV(0.0895)| NAC(0.0645)| Pu(0.0261)| GPe(0.0235)| GPeC(0.0014)| GPeR(0.0007)| GPi(0.0)| SN(0.0)| SN-VTA(0.0)| STH(0.0)	Balanced	0	0	0	0	0	0.0133	0.0882	6441	30071	4.67
AIT117_176	MSN_34		AIT117_344	STRd D1D2 Hybrid	cluster							295	3	['CRHR2', 'LINC01951', 'OTOF']	['CRHR2', 'CASZ1', 'S100Z', 'LINC01951', 'MEIKIN', 'OTOF', 'CACNA1I', 'KCNH4', 'LINC01118', 'KCNT1']	H23.30.001(0.4983)| H20.30.001(0.3797)| H20.30.002(0.0644)| H18.30.001(0.0576)| H19.30.004(0.0)	Balanced	Balanced	2006_B05 (0.1559)|2016_C03 (0.1424)|1042_B06 (0.0949)|988_E05 (0.0712)|1036_B03 (0.0441)|930_C05 (0.0441)|980_C02 (0.0305)|930_E05 (0.0305)|2018_E01 (0.0305)|2006_A05 (0.0271)|1036_C03 (0.0237)|1955_B06 (0.0237)|1955_C06 (0.0237)|2012_C05 (0.0203)|2013_C01 (0.0203)|1042_C06 (0.0203)|930_D05 (0.0203)|1110_A07 (0.0203)|1959_C02 (0.0169)|960_B03 (0.0169)|1110_B07 (0.0136)|2016_B03 (0.0136)|2018_C01 (0.0102)|2018_B01 (0.0102)|1036_A03 (0.0102)|988_D05 (0.0102)	0.1559	2006_B05 (0.1559)|a total of 6534 cells in this dominant library	NAC(0.2373)| PuPV(0.2305)| GPe(0.1661)| CaT(0.0949)| CaB(0.0847)| CaH(0.0814)| Pu(0.0407)| PuC(0.0373)| GPeR(0.0169)| PuR(0.0102)| GPeC(0.0)| GPi(0.0)| SN(0.0)| SN-VTA(0.0)| STH(0.0)	Balanced	0	0	0	0	0	0.0135	0.1226	4020	11595	2.88
AIT117_177	MSN_35		AIT117_345	STRv D1 NUDAP	cluster							1272	3	['CALCRL', 'RXFP1', 'ACVR1C']	['DNAH8', 'CCDC196', 'CALCRL', 'RXFP1', 'LAMA3', 'ACVR1C', 'PCDH11Y', 'LINC02137', 'ANKRD29', 'ARHGAP18']	H23.30.001(0.4009)| H20.30.002(0.2869)| H20.30.001(0.1714)| H18.30.001(0.1407)| H19.30.004(0.0)	Balanced	Balanced	1036_C03 (0.1847)|2018_C01 (0.1431)|2016_C03 (0.0833)|988_D05 (0.0786)|1042_A06 (0.0535)|1042_C06 (0.0535)|2006_B05 (0.0385)|1042_B06 (0.0283)|2012_A05 (0.0259)|930_B05 (0.0236)|2013_A01 (0.0212)|988_E05 (0.0197)|930_E05 (0.0189)|1036_B03 (0.0149)|1091_A05 (0.0142)|1110_B07 (0.0126)|2018_E01 (0.0126)|2013_C01 (0.0118)|1955_C06 (0.0118)|930_C05 (0.0110)|1482_A03 (0.0110)|891_A06 (0.0110)|1036_A03 (0.0102)	0.1847	1036_C03 (0.1847)|a total of 10219 cells in this dominant library	NAC(0.3868)| GPe(0.2288)| PuPV(0.1226)| CaT(0.1053)| CaB(0.044)| CaH(0.0362)| PuC(0.0275)| GPi(0.0228)| Pu(0.0165)| GPeR(0.0063)| PuR(0.0024)| GPeC(0.0008)| SN(0.0)| SN-VTA(0.0)| STH(0.0)	Balanced	0	0	0	0	0.39	0.0252	0.1868	5653	22294	3.94
AIT117_178	MSN_36		AIT117_345	STRv D1 NUDAP	cluster							133	3	['LMNTD1', 'CALCRL', 'SAMD3']	['LMNTD1', 'LINC02133', 'PDYN', 'CALCRL', 'SAMD3', 'ZNF711', 'PCDH11Y', 'VWC2L', 'BICC1', 'CREG2']	H23.30.001(0.7744)| H20.30.001(0.1053)| H20.30.002(0.0752)| H18.30.001(0.0451)| H19.30.004(0.0)	Balanced	Balanced	2016_C03 (0.3459)|2018_C01 (0.1579)|2012_B05 (0.0902)|2012_A05 (0.0827)|2006_B05 (0.0451)|988_D05 (0.0376)|1482_A03 (0.0376)|980_C02 (0.0301)|930_B05 (0.0301)|1042_B06 (0.0226)|2013_A01 (0.0226)|1042_A06 (0.0150)|1036_C03 (0.0150)	0.3459	2016_C03 (0.3459)|a total of 8224 cells in this dominant library	PuPV(0.3609)| GPe(0.3083)| GPi(0.1429)| CaT(0.0827)| NAC(0.0677)| PuC(0.0301)| CaB(0.0075)| GPeR(0.0)| GPeC(0.0)| CaH(0.0)| Pu(0.0)| PuR(0.0)| SN(0.0)| SN-VTA(0.0)| STH(0.0)	Balanced	0	0	0	0	0.39	0.0645	0.1474	5696	22524	3.95
AIT117_179	MSN_37		AIT117_345	STRv D1 NUDAP	cluster							177	3	['LMNTD1', 'LINC00354', 'AC096576.3']	['LMNTD1', 'LINC00354', 'RXFP1', 'LAMA3', 'AC096576.3', 'ARHGAP18', 'AC008415.1', 'VAV3', 'GHR', 'AL596087.2']	H18.30.001(0.5706)| H20.30.001(0.209)| H23.30.001(0.1525)| H20.30.002(0.0678)| H19.30.004(0.0)	Balanced	Balanced	1110_B07 (0.3333)|1110_A07 (0.2260)|994_C03 (0.1130)|2018_C01 (0.0678)|1042_B06 (0.0621)|1036_C03 (0.0339)|1042_A06 (0.0282)|1042_C06 (0.0169)|2013_A01 (0.0169)|2006_B05 (0.0169)|2016_C03 (0.0169)|1955_C06 (0.0113)|960_B03 (0.0113)	0.3333	1110_B07 (0.3333)|a total of 4786 cells in this dominant library	NAC(0.7175)| GPi(0.1186)| GPe(0.1073)| PuPV(0.0226)| GPeR(0.0169)| Pu(0.0113)| CaB(0.0056)| GPeC(0.0)| CaT(0.0)| CaH(0.0)| PuC(0.0)| PuR(0.0)| SN(0.0)| SN-VTA(0.0)| STH(0.0)	Balanced	0	0	0	0	0.58	0.0323	0.0493	3869	11952	3.09
AIT117_180	MSN_38		AIT117_344	STRd D1D2 Hybrid	cluster							1633	3	['FRMD7', 'RGS5', 'CALCRL']	['FRMD7', 'RGS5', 'SCN5A', 'CALCRL', 'RXFP1', 'GDNF-AS1', 'TLL1', 'GFRA1', 'AL356124.1', 'ARHGAP18']	H23.30.001(0.387)| H18.30.001(0.2701)| H20.30.001(0.2633)| H20.30.002(0.0796)| H19.30.004(0.0)	Balanced	Balanced	988_D05 (0.1482)|980_C02 (0.1053)|2018_C01 (0.0900)|930_E05 (0.0716)|847_A04 (0.0680)|2006_B05 (0.0527)|2016_C03 (0.0465)|2018_E01 (0.0312)|891_A06 (0.0294)|2018_B01 (0.0288)|2012_A05 (0.0269)|822_B01 (0.0227)|988_E05 (0.0208)|2013_C01 (0.0208)|930_C05 (0.0202)|2013_A01 (0.0190)|1042_C06 (0.0184)|1036_C03 (0.0135)|2012_C05 (0.0135)|2006_A05 (0.0135)|988_C05 (0.0122)|1955_C06 (0.0110)|1042_B06 (0.0104)	0.1482	988_D05 (0.1482)|a total of 8686 cells in this dominant library	CaT(0.3105)| GPe(0.1886)| CaB(0.1402)| PuPV(0.1237)| CaH(0.0998)| NAC(0.0631)| PuC(0.0165)| Pu(0.0153)| GPi(0.0147)| PuR(0.0116)| GPeC(0.008)| GPeR(0.008)| SN(0.0)| SN-VTA(0.0)| STH(0.0)	Balanced	0	0	0	0	0	0.04	0.1263	6087	25262	4.15
AIT117_39	MSN_39		AIT117_344	STRd D1D2 Hybrid	cluster							179	4	['LMNTD1', 'NPFFR2', 'AC022126.1', 'KLHL4']	['LMNTD1', 'NPFFR2', 'CALCRL', 'AC022126.1', 'PTPRQ', 'KLHL4', 'B3GAT2', 'RPL36A', 'PCDH11Y', 'TOMM7']	H23.30.001(0.7877)| H18.30.001(0.095)| H20.30.001(0.067)| H20.30.002(0.0503)| H19.30.004(0.0)	Balanced	Balanced	2018_C01 (0.5754)|988_D05 (0.0670)|1042_C06 (0.0335)|2013_A01 (0.0335)|2016_C03 (0.0335)|2013_C01 (0.0279)|2018_E01 (0.0279)|2018_B01 (0.0223)|988_E05 (0.0168)|988_C05 (0.0168)|1036_C03 (0.0168)|2006_B05 (0.0168)|1036_B03 (0.0112)|1042_A06 (0.0112)|2018_D01 (0.0112)|891_A06 (0.0112)|853_B07 (0.0112)|2016_B03 (0.0112)|1959_C02 (0.0112)	0.5754	2018_C01 (0.5754)|a total of 7029 cells in this dominant library	GPe(0.6313)| CaT(0.1229)| NAC(0.0782)| PuPV(0.0726)| CaB(0.0391)| GPi(0.0168)| GPeC(0.0112)| Pu(0.0112)| PuC(0.0112)| PuR(0.0056)| CaH(0.0)| GPeR(0.0)| SN(0.0)| SN-VTA(0.0)| STH(0.0)	Balanced	0	0	0	0	0.24	0.04	0.0677	5296	19373	3.66
AIT117_181	MSN_40		AIT117_344	STRd D1D2 Hybrid	cluster							323	5	['PDYN', 'CALCRL', 'XIST', 'MT-ATP8', 'GFRA1']	['AC068633.1', 'PDYN', 'CALCRL', 'XIST', 'MT-ATP8', 'GFRA1', 'SEMA3E', 'MT-ND4L', 'IL1RAP', 'CD226']	H18.30.001(0.5851)| H23.30.001(0.2105)| H20.30.002(0.1858)| H20.30.001(0.0186)| H19.30.004(0.0)	Balanced	Balanced	988_D05 (0.5418)|822_B01 (0.1300)|2006_B05 (0.0526)|2016_C03 (0.0433)|1036_C03 (0.0341)|2018_C01 (0.0310)|847_A04 (0.0248)|2018_E01 (0.0248)|2018_B01 (0.0124)|2013_A01 (0.0124)	0.5418	988_D05 (0.5418)|a total of 8686 cells in this dominant library	CaT(0.5851)| PuPV(0.1889)| GPe(0.0991)| NAC(0.0464)| CaH(0.0279)| CaB(0.0248)| PuC(0.0124)| GPeC(0.0062)| PuR(0.0062)| GPeR(0.0031)| GPi(0.0)| Pu(0.0)| SN(0.0)| SN-VTA(0.0)| STH(0.0)	Balanced	0	0	0	0	0	0.02	0.4655	6233	26118	4.19
AIT117_182	MSN_41		AIT117_346	STRd D2 StrioMat Hybrid	cluster							1096	3	['HTR7', 'AC132153.1', 'MYO1B']	['AC048352.1', 'AC079148.3', 'HTR7', 'AC132153.1', 'POU6F2', 'MYO1B', 'DRD2', 'SULF2', 'LINC02223', 'TTN']	H20.30.001(0.3285)| H20.30.002(0.2938)| H18.30.001(0.1916)| H23.30.001(0.1861)| H19.30.004(0.0)	Balanced	Balanced	1036_B03 (0.1186)|1042_C06 (0.1068)|1036_C03 (0.1049)|1036_A03 (0.0912)|1091_A05 (0.0867)|1042_B06 (0.0812)|1042_A06 (0.0666)|1959_A02 (0.0465)|1110_B07 (0.0456)|1110_A07 (0.0438)|2006_B05 (0.0255)|1955_C06 (0.0228)|2013_A01 (0.0164)|822_A01 (0.0146)|1959_B02 (0.0137)|2018_C01 (0.0109)	0.1186	1036_B03 (0.1186)|a total of 8553 cells in this dominant library	NAC(0.792)| GPe(0.0593)| CaH(0.0392)| Pu(0.0328)| PuPV(0.021)| CaT(0.0155)| PuR(0.0146)| CaB(0.0137)| GPi(0.0064)| GPeR(0.0018)| GPeC(0.0018)| PuC(0.0018)| SN(0.0)| SN-VTA(0.0)| STH(0.0)	Balanced	0	0	0	0	0	0.0227	0.0625	7048.5	35429.5	5.03
AIT117_42	MSN_42		AIT117_346	STRd D2 StrioMat Hybrid	cluster							282	3	['CDK15', 'AC048352.1', 'AL356295.1']	['CDK15', 'AC048352.1', 'LINC00707', 'FHAD1', 'AC005482.1', 'AL356295.1', 'GPR6', 'AC132153.1', 'POU6F2', 'AC004160.1']	H23.30.001(0.8262)| H20.30.002(0.0922)| H18.30.001(0.0532)| H20.30.001(0.0284)| H19.30.004(0.0)	Balanced	Balanced	1955_C06 (0.4645)|1955_B06 (0.1560)|2006_B05 (0.0851)|1036_A03 (0.0532)|1959_C02 (0.0355)|1091_A05 (0.0213)|822_A01 (0.0213)|2006_A05 (0.0177)|2013_C01 (0.0177)|1036_B03 (0.0177)|1959_A02 (0.0142)|847_B04 (0.0142)|1959_B02 (0.0142)|988_D05 (0.0106)	0.4645	1955_C06 (0.4645)|a total of 8987 cells in this dominant library	Pu(0.5)| CaH(0.1773)| NAC(0.117)| GPe(0.0887)| CaB(0.039)| PuR(0.0355)| CaT(0.0213)| PuPV(0.0177)| PuC(0.0035)| GPeC(0.0)| GPeR(0.0)| GPi(0.0)| SN(0.0)| SN-VTA(0.0)| STH(0.0)	Balanced	0	0	0	0	0	0.0686	0.1055	5469	18424	3.37
AIT117_43	MSN_43		AIT117_346	STRd D2 StrioMat Hybrid	cluster							1051	4	['LINC00707', 'FHAD1', 'POU6F2', 'RCBTB1']	['AC048352.1', 'LINC00707', 'FHAD1', 'AL356295.1', 'POU6F2', 'RCBTB1', 'SLC22A10', 'DRD2', 'SEMA3E', 'SMYD2']	H20.30.001(0.3435)| H23.30.001(0.3121)| H20.30.002(0.1827)| H18.30.001(0.1618)| H19.30.004(0.0)	Balanced	Balanced	930_D05 (0.0923)|822_A01 (0.0818)|847_A04 (0.0599)|930_F05 (0.0552)|988_E05 (0.0504)|1959_C02 (0.0495)|930_E05 (0.0485)|2018_B01 (0.0466)|1959_B02 (0.0400)|988_D05 (0.0381)|930_C05 (0.0371)|2006_A05 (0.0343)|2016_C03 (0.0266)|1036_A03 (0.0247)|2016_B03 (0.0247)|1036_B03 (0.0228)|897_E03 (0.0219)|980_C02 (0.0171)|822_B01 (0.0162)|2013_C01 (0.0162)|1959_A02 (0.0152)|1042_A06 (0.0133)|847_B04 (0.0124)|2018_C01 (0.0124)|2018_E01 (0.0124)|2018_A01 (0.0124)|1042_C06 (0.0114)|1091_A05 (0.0114)	0.0923	930_D05 (0.0923)|a total of 8788 cells in this dominant library	CaH(0.1513)| PuR(0.1494)| PuPV(0.1484)| PuC(0.1427)| CaB(0.1304)| NAC(0.1275)| CaT(0.0752)| Pu(0.0542)| GPe(0.0209)| GPeC(0.0)| GPeR(0.0)| GPi(0.0)| SN(0.0)| SN-VTA(0.0)| STH(0.0)	Balanced	0	0	0	0	0	0.1	0.0655	7627	45196	5.93
AIT117_183	MSN_44		AIT117_346	STRd D2 StrioMat Hybrid	cluster							361	3	['FHAD1', 'SEC16B', 'AL356295.1']	['AC004704.1', 'FHAD1', 'SEC16B', 'AL356295.1', 'LINC02197', 'HTR2A', 'LOXHD1', 'GFRA1', 'COL21A1', 'RBM20']	H23.30.001(0.5734)| H20.30.001(0.2022)| H18.30.001(0.1468)| H20.30.002(0.0776)| H19.30.004(0.0)	Balanced	Balanced	2018_C01 (0.2299)|2018_B01 (0.1330)|988_D05 (0.1191)|988_E05 (0.0859)|2018_E01 (0.0609)|2013_C01 (0.0526)|822_B01 (0.0471)|980_C02 (0.0416)|930_E05 (0.0388)|2016_C03 (0.0249)|1042_C06 (0.0222)|2006_B05 (0.0194)|2006_A05 (0.0166)|897_E03 (0.0111)|2013_A01 (0.0111)	0.2299	2018_C01 (0.2299)|a total of 7029 cells in this dominant library	PuPV(0.2909)| GPe(0.2659)| CaT(0.2299)| CaB(0.1274)| NAC(0.0526)| PuC(0.0222)| CaH(0.0055)| GPeC(0.0028)| PuR(0.0028)| GPi(0.0)| GPeR(0.0)| Pu(0.0)| SN(0.0)| SN-VTA(0.0)| STH(0.0)	Balanced	0	0	0	0	0.5	0.08	0.0395	7218	37185	5.15
AIT117_46	MSN_46		AIT117_340	STRv D1 Shell	cluster							153	5	['LINC01435', 'AC126121.3', 'CALCRL', 'AL591501.1', 'HUNK']	['LINC01435', 'AC126121.3', 'CALCRL', 'AL591501.1', 'HUNK', 'GDA', 'C3orf67-AS1', 'RBM20', 'AL138828.1', 'DCHS2']	H18.30.001(0.7451)| H20.30.002(0.2353)| H23.30.001(0.0196)| H20.30.001(0.0)| H19.30.004(0.0)	Balanced	Balanced	1110_B07 (0.4510)|1110_A07 (0.2876)|1042_A06 (0.2288)	0.451	1110_B07 (0.451)|a total of 4786 cells in this dominant library	NAC(0.9739)| GPe(0.0196)| PuC(0.0065)| CaT(0.0)| GPeC(0.0)| CaH(0.0)| CaB(0.0)| GPi(0.0)| GPeR(0.0)| Pu(0.0)| PuPV(0.0)| PuR(0.0)| SN(0.0)| SN-VTA(0.0)| STH(0.0)	Cautious	0	0	0	0	0.24	0.0556	0.0491	4922	16985	3.45
AIT117_184	MSN_47		AIT117_340	STRv D1 Shell	cluster							148	5	['AP003121.1', 'CAV1', 'CAV2', 'AP001993.1', 'LINC02712']	['AP003121.1', 'CAV1', 'CAV2', 'AC002066.1', 'AP001993.1', 'LINC02712', 'SLC38A11', 'CCK', 'STAC', 'SEMA3E']	H20.30.002(0.9257)| H18.30.001(0.0473)| H20.30.001(0.0135)| H23.30.001(0.0135)| H19.30.004(0.0)	Cautious	Balanced	1042_A06 (0.8243)|1036_C03 (0.0946)|1110_B07 (0.0270)|1110_A07 (0.0135)	0.8243	1042_A06 (0.8243)|a total of 6282 cells in this dominant library	NAC(0.973)| GPe(0.0135)| CaT(0.0068)| CaH(0.0068)| CaB(0.0)| GPeR(0.0)| GPeC(0.0)| GPi(0.0)| Pu(0.0)| PuC(0.0)| PuPV(0.0)| PuR(0.0)| SN(0.0)| SN-VTA(0.0)| STH(0.0)	Cautious	0	0	0	0	0.24	0.0423	0.184	7907.5	47506.5	6.01
AIT117_185	MSN_48		AIT117_347	OT D1-ICj	cluster							79	4	['DIO2-AS1', 'CAV2', 'AC002066.1', 'COL4A1']	['DIO2-AS1', 'CAV2', 'AC002066.1', 'CCDC196', 'PTH2R', 'COL4A1', 'CXCL14', 'SLC25A48', 'NPNT', 'STAC']	H18.30.001(0.8987)| H20.30.002(0.0633)| H20.30.001(0.0253)| H23.30.001(0.0127)| H19.30.004(0.0)	Balanced	Balanced	1110_A07 (0.5570)|1110_B07 (0.3418)|1042_A06 (0.0633)|2012_A05 (0.0127)|1036_B03 (0.0127)|1482_A03 (0.0127)	0.557	1110_A07 (0.557)|a total of 4046 cells in this dominant library	NAC(0.9747)| GPi(0.0127)| GPe(0.0127)| CaT(0.0)| CaH(0.0)| GPeC(0.0)| CaB(0.0)| GPeR(0.0)| Pu(0.0)| PuC(0.0)| PuPV(0.0)| PuR(0.0)| SN(0.0)| SN-VTA(0.0)| STH(0.0)	Cautious	0	0	0	0	0	0.0323	0.0491	4270	12738	2.98
AIT117_186	MSN_49		AIT117_347	OT D1-ICj	cluster							82	4	['CCDC196', 'ABI3BP', 'NPNT', 'MYO1B']	['CAV1', 'AC002066.1', 'CCDC196', 'ABI3BP', 'NPNT', 'MYO1B', 'SLC25A48', 'LINC01951', 'AL591501.1', 'MYO3A']	H23.30.001(0.6341)| H18.30.001(0.1707)| H20.30.002(0.1098)| H20.30.001(0.0854)| H19.30.004(0.0)	Balanced	Balanced	2018_C01 (0.5000)|1110_A07 (0.1220)|1042_A06 (0.0976)|2013_A01 (0.0854)|1482_A03 (0.0732)|2012_A05 (0.0488)|1110_B07 (0.0366)|1042_C06 (0.0122)|853_B07 (0.0122)|1036_C03 (0.0122)	0.5	2018_C01 (0.5)|a total of 7029 cells in this dominant library	GPe(0.6341)| NAC(0.2805)| GPi(0.0732)| GPeC(0.0122)| CaT(0.0)| CaB(0.0)| CaH(0.0)| GPeR(0.0)| Pu(0.0)| PuC(0.0)| PuPV(0.0)| PuR(0.0)| SN(0.0)| SN-VTA(0.0)| STH(0.0)	Balanced	0.5	0.5	0	0	0.12	0.0914	0.0477	6560	30360.5	4.63
AIT117_187	MSN_51		AIT117_341	STRd D1 Matrix	cluster							138	6	['LINC02652', 'AC244131.2', 'AL359220.1', 'AC015631.1', 'AC073365.1', 'AC004551.1']	['LINC02652', 'AC244131.2', 'AL359220.1', 'AC015631.1', 'AC073365.1', 'AC004551.1', 'AC068875.1', 'TMEM179', 'AL807742.1', 'AGBL1']	H20.30.001(0.8406)| H20.30.002(0.0942)| H23.30.001(0.058)| H18.30.001(0.0072)| H19.30.004(0.0)	Balanced	Balanced	1042_C06 (0.2681)|1042_B06 (0.2319)|1036_B03 (0.1449)|930_C05 (0.1377)|930_E05 (0.0507)|1036_C03 (0.0507)|1959_B02 (0.0362)|930_A05 (0.0217)|1036_A03 (0.0145)	0.2681	1042_C06 (0.2681)|a total of 6212 cells in this dominant library	NAC(0.7246)| CaH(0.1957)| CaB(0.058)| GPeR(0.0072)| GPe(0.0072)| Pu(0.0072)| CaT(0.0)| GPi(0.0)| GPeC(0.0)| PuC(0.0)| PuPV(0.0)| PuR(0.0)| SN(0.0)| SN-VTA(0.0)| STH(0.0)	Balanced	0	0	0	0	0	0.0411	0.0921	7638	48718.5	6.38
AIT117_188	MSN_52		AIT117_338	STRd D2 Matrix	cluster							2927	3	['TSIX', 'XIST', 'DRD2']	['TSIX', 'SOX9-AS1', 'SYNPR-AS1', 'XIST', 'LINC01117', 'DRD2', 'AP000787.1', 'SLC24A4', 'OCA2', 'AC005400.1']	H18.30.001(0.8428)| H20.30.002(0.111)| H20.30.001(0.0301)| H23.30.001(0.0161)| H19.30.004(0.0)	Balanced	Balanced	1110_A07 (0.4414)|1110_B07 (0.3932)|1036_C03 (0.0478)|1042_A06 (0.0444)|1036_B03 (0.0106)|1042_C06 (0.0102)	0.4414	1110_A07 (0.4414)|a total of 4046 cells in this dominant library	NAC(0.9716)| GPe(0.0092)| PuR(0.0085)| CaH(0.0044)| PuC(0.002)| GPi(0.002)| PuPV(0.001)| Pu(0.0003)| GPeR(0.0003)| CaB(0.0003)| CaT(0.0)| GPeC(0.0)| SN(0.0)| SN-VTA(0.0)| STH(0.0)	Cautious	0	0	0	0	0.49	0.027	0.0349	4269	13047	3.06
AIT117_53	MSN_53		AIT117_347	OT D1-ICj	cluster							134	2	['LINC02462', 'COL4A1']	['NTN1', 'LINC02462', 'AC015631.1', 'SEMA3C', 'COL4A1', 'NPNT', 'TCERG1L', 'INTS12', 'AL596214.1', 'NELL1']	H18.30.001(0.6716)| H23.30.001(0.1642)| H20.30.002(0.1119)| H20.30.001(0.0522)| H19.30.004(0.0)	Balanced	Balanced	1110_A07 (0.3806)|1110_B07 (0.2836)|1042_A06 (0.0597)|2013_A01 (0.0597)|2018_C01 (0.0448)|1036_C03 (0.0448)|1042_C06 (0.0373)|2013_C01 (0.0224)|1959_C02 (0.0149)|2006_B05 (0.0149)	0.3806	1110_A07 (0.3806)|a total of 4046 cells in this dominant library	NAC(0.806)| GPe(0.1194)| CaB(0.0224)| Pu(0.0149)| GPeC(0.0075)| GPeR(0.0075)| CaT(0.0075)| PuPV(0.0075)| GPi(0.0075)| CaH(0.0)| PuC(0.0)| PuR(0.0)| SN(0.0)| SN-VTA(0.0)| STH(0.0)	Balanced	0	0	0	0	0	0.0323	0.0515	3616	10357	2.86
AIT117_189	MSN_54		AIT117_347	OT D1-ICj	cluster							170	3	['CAV1', 'NTN1', 'CXCL14']	['CAV1', 'ISL1', 'PTGER3', 'AC002066.1', 'NTN1', 'CXCL14', 'NPNT', 'LINC01951', 'GDA', 'PLCXD3']	H23.30.001(0.5941)| H20.30.001(0.2118)| H20.30.002(0.1235)| H18.30.001(0.0706)| H19.30.004(0.0)	Balanced	Balanced	2018_C01 (0.3941)|1482_A03 (0.1471)|2013_A01 (0.0765)|1042_C06 (0.0588)|1042_A06 (0.0529)|1036_C03 (0.0471)|2012_B05 (0.0471)|1110_B07 (0.0294)|853_B07 (0.0294)|2012_A05 (0.0294)|822_A01 (0.0176)|1110_A07 (0.0118)|2013_C01 (0.0118)	0.3941	2018_C01 (0.3941)|a total of 7029 cells in this dominant library	GPe(0.5059)| NAC(0.2118)| GPi(0.2059)| GPeC(0.0294)| PuR(0.0176)| CaB(0.0118)| CaH(0.0059)| PuPV(0.0059)| CaT(0.0059)| GPeR(0.0)| Pu(0.0)| PuC(0.0)| SN(0.0)| SN-VTA(0.0)| STH(0.0)	Balanced	0	0	0.24	0.24	0.24	0.0545	0.0857	5536.5	21121.5	3.82
AIT117_190	MSN_55		AIT117_341	STRd D1 Matrix	cluster							959	4	['AC068875.1', 'AC015631.1', 'LINC02822', 'AGBL1']	['AC068875.1', 'AC015631.1', 'LINC02822', 'LINC01117', 'AGBL1', 'LINC01951', 'EBF1', 'TRPC6', 'AL591501.1', 'LINC02112']	H23.30.001(0.7873)| H20.30.002(0.0876)| H20.30.001(0.0761)| H18.30.001(0.049)| H19.30.004(0.0)	Balanced	Balanced	2006_B05 (0.6340)|2013_A01 (0.0834)|1036_C03 (0.0678)|2006_A05 (0.0386)|1110_B07 (0.0334)|930_C05 (0.0271)|1042_C06 (0.0240)|1036_B03 (0.0136)|1959_B02 (0.0115)	0.634	2006_B05 (0.634)|a total of 6534 cells in this dominant library	GPe(0.7205)| NAC(0.1585)| CaB(0.0553)| CaH(0.0501)| PuR(0.0083)| Pu(0.0031)| PuPV(0.0021)| GPeR(0.001)| CaT(0.001)| GPi(0.0)| GPeC(0.0)| PuC(0.0)| SN(0.0)| SN-VTA(0.0)| STH(0.0)	Balanced	0	0	0	0	0	0.023	0.1275	4400	12254	2.79
AIT117_191	MSN_56		AIT117_345	STRv D1 NUDAP	cluster							271	4	['PTH2R', 'TSIX', 'XIST', 'RXFP1']	['DNAH8', 'CCDC196', 'PTH2R', 'TSIX', 'XIST', 'RXFP1', 'BEND7', 'PTPRQ', 'SLC22A10', 'OCA2']	H18.30.001(0.8487)| H20.30.001(0.0664)| H20.30.002(0.0554)| H23.30.001(0.0295)| H19.30.004(0.0)	Balanced	Balanced	1110_A07 (0.4576)|1110_B07 (0.3764)|1042_A06 (0.0332)|1042_C06 (0.0221)|1036_B03 (0.0185)|2018_C01 (0.0148)|1091_A05 (0.0148)|1036_C03 (0.0111)|1042_B06 (0.0111)|988_E05 (0.0111)	0.4576	1110_A07 (0.4576)|a total of 4046 cells in this dominant library	NAC(0.952)| PuPV(0.0185)| GPe(0.0148)| PuR(0.0074)| Pu(0.0037)| CaB(0.0037)| CaH(0.0)| GPi(0.0)| GPeR(0.0)| GPeC(0.0)| CaT(0.0)| PuC(0.0)| SN(0.0)| SN-VTA(0.0)| STH(0.0)	Cautious	0	0	0	0	0.5	0.0323	0.0313	4475	14931	3.34
AIT117_192	MSN_57		AIT117_345	STRv D1 NUDAP	cluster							256	5	['DNAH8', 'CXCL14', 'RXFP1', 'COL4A1', 'BEND7']	['DNAH8', 'PTH2R', 'CXCL14', 'RXFP1', 'COL4A1', 'BEND7', 'PTPRQ', 'SLC25A48', 'SLC22A10', 'NPNT']	H20.30.002(0.5977)| H20.30.001(0.2305)| H18.30.001(0.1133)| H23.30.001(0.0586)| H19.30.004(0.0)	Balanced	Balanced	1042_A06 (0.4258)|1042_C06 (0.1719)|1036_C03 (0.1406)|1110_B07 (0.0586)|1091_A05 (0.0312)|1042_B06 (0.0234)|1110_A07 (0.0234)|822_A01 (0.0234)|988_E05 (0.0195)|2018_C01 (0.0156)|1959_C02 (0.0156)|2006_B05 (0.0117)|1959_A02 (0.0117)|1036_B03 (0.0117)	0.4258	1042_A06 (0.4258)|a total of 6282 cells in this dominant library	NAC(0.9062)| GPe(0.0273)| PuPV(0.0234)| PuR(0.0234)| Pu(0.0156)| GPi(0.0039)| CaB(0.0)| GPeR(0.0)| GPeC(0.0)| CaH(0.0)| CaT(0.0)| PuC(0.0)| SN(0.0)| SN-VTA(0.0)| STH(0.0)	Balanced	0	0	0	0	0.5	0.0274	0.211	6622.5	31938.5	4.82
AIT117_193	MSN_58		AIT117_345	STRv D1 NUDAP	cluster							111	4	['CHRM5', 'RXFP1', 'PKP2', 'GDNF-AS1']	['MCOLN3', 'LINC01550', 'CHRM5', 'RXFP1', 'PKP2', 'GDNF-AS1', 'EYA2', 'PCDH11Y', 'VWC2L', 'GDA']	H20.30.002(0.4234)| H23.30.001(0.3694)| H18.30.001(0.1081)| H20.30.001(0.0991)| H19.30.004(0.0)	Balanced	Balanced	1042_A06 (0.3604)|2018_C01 (0.2703)|1042_C06 (0.0541)|1036_C03 (0.0450)|1482_A03 (0.0450)|1110_B07 (0.0450)|1091_A05 (0.0450)|2013_A01 (0.0450)|2006_B05 (0.0270)|2012_A05 (0.0180)	0.3604	1042_A06 (0.3604)|a total of 6282 cells in this dominant library	NAC(0.5676)| GPe(0.3604)| GPi(0.0541)| PuR(0.009)| GPeC(0.009)| CaT(0.0)| CaH(0.0)| GPeR(0.0)| CaB(0.0)| PuC(0.0)| Pu(0.0)| PuPV(0.0)| SN(0.0)| SN-VTA(0.0)| STH(0.0)	Balanced	0	0	0	0	0	0.0323	0.103	6081	24788	4.08
AIT117_194	MSN_59		AIT117_345	STRv D1 NUDAP	cluster							215	3	['CHRM5', 'XIST', 'RXFP1']	['NPFFR2', 'TSIX', 'SYNPR-AS1', 'CHRM5', 'XIST', 'RXFP1', 'AC068051.1', 'EYA2', 'VWC2L', 'AC096576.3']	H18.30.001(0.7814)| H23.30.001(0.1023)| H20.30.002(0.0884)| H20.30.001(0.0279)| H19.30.004(0.0)	Balanced	Balanced	1110_A07 (0.4093)|1110_B07 (0.3628)|2018_C01 (0.0884)|1042_A06 (0.0791)	0.4093	1110_A07 (0.4093)|a total of 4046 cells in this dominant library	NAC(0.8791)| GPe(0.093)| GPi(0.0093)| PuPV(0.0093)| Pu(0.0047)| GPeR(0.0047)| CaT(0.0)| GPeC(0.0)| CaB(0.0)| CaH(0.0)| PuC(0.0)| PuR(0.0)| SN(0.0)| SN-VTA(0.0)| STH(0.0)	Balanced	0	0	0	0	0	0.0323	0.0439	4080	12818	3.14
AIT117_195	MSN_60		AIT117_345	STRv D1 NUDAP	cluster							308	3	['SAMD3', 'PENK', 'VWC2L']	['RXFP1', 'AC068051.1', 'SAMD3', 'GNG4', 'PENK', 'VWC2L', 'PCDH11Y', 'TRHDE', 'PLCH1', 'TSHZ1']	H23.30.001(0.3831)| H20.30.002(0.2403)| H20.30.001(0.211)| H18.30.001(0.1656)| H19.30.004(0.0)	Balanced	Balanced	2018_C01 (0.2110)|1042_A06 (0.1234)|1110_A07 (0.0779)|1482_A03 (0.0747)|1036_C03 (0.0519)|1042_C06 (0.0455)|2006_B05 (0.0422)|2013_A01 (0.0357)|988_E05 (0.0357)|822_A01 (0.0325)|1959_C02 (0.0292)|1110_B07 (0.0227)|1042_B06 (0.0195)|1036_B03 (0.0195)|988_C05 (0.0195)|853_B07 (0.0195)|1091_A05 (0.0162)|847_C04 (0.0162)|960_B03 (0.0130)	0.211	2018_C01 (0.211)|a total of 7029 cells in this dominant library	NAC(0.3896)| GPe(0.2987)| GPi(0.0877)| PuPV(0.0682)| Pu(0.039)| PuR(0.0325)| CaT(0.026)| GPeC(0.0195)| GPeR(0.0162)| CaB(0.013)| PuC(0.0097)| CaH(0.0)| SN(0.0)| SN-VTA(0.0)| STH(0.0)	Balanced	0	0	0	0	0	0.0282	0.1199	5858	23436.5	4
AIT117_196	MSN_61		AIT117_345	STRv D1 NUDAP	cluster							558	3	['PTH2R', 'RXFP1', 'GDNF-AS1']	['NPFFR2', 'PTH2R', 'ENPP2', 'CXCL14', 'RXFP1', 'GDNF-AS1', 'IL1RAP', 'AC011246.1', 'PCDH11Y', 'CUX2']	H23.30.001(0.5305)| H20.30.001(0.2527)| H20.30.002(0.1183)| H18.30.001(0.0986)| H19.30.004(0.0)	Balanced	Balanced	2018_C01 (0.4158)|1482_A03 (0.1362)|988_E05 (0.0860)|1042_A06 (0.0609)|1110_A07 (0.0502)|1036_C03 (0.0341)|2013_A01 (0.0269)|1110_B07 (0.0215)|1042_C06 (0.0215)|2006_B05 (0.0125)|2012_B05 (0.0125)|988_C05 (0.0125)|2012_A05 (0.0125)|2016_B03 (0.0108)	0.4158	2018_C01 (0.4158)|a total of 7029 cells in this dominant library	GPe(0.4677)| NAC(0.1953)| GPi(0.1613)| PuPV(0.1093)| PuC(0.0215)| CaT(0.0197)| GPeC(0.009)| PuR(0.0054)| Pu(0.0054)| GPeR(0.0036)| CaH(0.0018)| CaB(0.0)| SN(0.0)| SN-VTA(0.0)| STH(0.0)	Balanced	0	0	0	0	0.24	0.0526	0.0866	5984	25839.5	4.32
AIT117_197	MSN_62		AIT117_345	STRv D1 NUDAP	cluster							777	3	['RXFP1', 'EYA2', 'PROS1']	['NPFFR2', 'RXFP1', 'EYA2', 'TLL1', 'PROS1', 'PCDH11Y', 'VWC2L', 'CADPS2', 'PLCXD3', 'FOXP2']	H23.30.001(0.5959)| H20.30.001(0.1699)| H20.30.002(0.1364)| H18.30.001(0.0978)| H19.30.004(0.0)	Balanced	Balanced	2018_C01 (0.4453)|1482_A03 (0.1171)|1042_A06 (0.0721)|1036_C03 (0.0412)|1110_A07 (0.0386)|2013_A01 (0.0360)|1110_B07 (0.0283)|2012_B05 (0.0257)|2012_A05 (0.0219)|1042_C06 (0.0206)|853_B07 (0.0154)|988_E05 (0.0142)|822_A01 (0.0129)|2006_B05 (0.0116)|2016_C03 (0.0116)|1955_C06 (0.0103)	0.4453	2018_C01 (0.4453)|a total of 7029 cells in this dominant library	GPe(0.5148)| NAC(0.2201)| GPi(0.1596)| PuPV(0.0309)| GPeC(0.0154)| Pu(0.0142)| PuR(0.0129)| CaT(0.009)| CaB(0.0077)| GPeR(0.0077)| PuC(0.0064)| CaH(0.0013)| SN(0.0)| SN-VTA(0.0)| STH(0.0)	Balanced	0	0	0	0	0	0.027	0.0971	4871	15318	3.14
AIT117_63	MSN_63		AIT117_345	STRv D1 NUDAP	cluster							329	3	['LINC01798', 'AC008127.1', 'CACNG5']	['LINC01798', 'AC008127.1', 'AL365255.1', 'NPFFR2', 'PTH2R', 'CACNG5', 'ADAMTSL1', 'ST8SIA6', 'TAC1', 'EPHA3']	H23.30.001(0.6079)| H20.30.001(0.1854)| H20.30.002(0.1064)| H18.30.001(0.1003)| H19.30.004(0.0)	Balanced	Balanced	2018_C01 (0.4498)|1482_A03 (0.0881)|988_C05 (0.0729)|847_C04 (0.0699)|988_E05 (0.0669)|2016_B03 (0.0365)|2012_B05 (0.0243)|2016_C03 (0.0213)|1110_A07 (0.0182)|2012_A05 (0.0152)|822_B01 (0.0152)|2006_B05 (0.0152)|930_D05 (0.0122)|930_B05 (0.0122)|2018_A01 (0.0122)	0.4498	2018_C01 (0.4498)|a total of 7029 cells in this dominant library	GPe(0.4863)| PuPV(0.1824)| GPi(0.1185)| CaT(0.079)| PuC(0.076)| NAC(0.0304)| CaB(0.0091)| Pu(0.0091)| PuR(0.0061)| GPeR(0.003)| CaH(0.0)| GPeC(0.0)| SN(0.0)| SN-VTA(0.0)| STH(0.0)	Balanced	0	0	0	0	0	0.0625	0.0889	6055	26419	4.36
AIT117_198	MSN_64		AIT117_345	STRv D1 NUDAP	cluster							462	3	['LINC00390', 'LINC01776', 'EYA2']	['LINC00390', 'AC069133.1', 'NPFFR2', 'LINC01776', 'EYA2', 'PRLR', 'MIR4500HG', 'EPHA3', 'PCDH11Y', 'SNX7']	H20.30.002(0.6039)| H20.30.001(0.2446)| H23.30.001(0.1429)| H18.30.001(0.0087)| H19.30.004(0.0)	Balanced	Balanced	988_C05 (0.5952)|1482_A03 (0.2338)|2018_C01 (0.0909)|2012_B05 (0.0216)	0.5952	988_C05 (0.5952)|a total of 5279 cells in this dominant library	CaT(0.5952)| GPi(0.2641)| GPe(0.0974)| NAC(0.0173)| PuPV(0.013)| CaB(0.0065)| GPeR(0.0022)| Pu(0.0022)| PuC(0.0022)| GPeC(0.0)| CaH(0.0)| PuR(0.0)| SN(0.0)| SN-VTA(0.0)| STH(0.0)	Balanced	0	0	0	0	0	0.0571	0.1766	6986.5	38462	5.51
AIT117_199	MSN_65		AIT117_340	STRv D1 Shell	cluster							254	2	['AC079052.1', 'MACROD2-AS1']	['AC079052.1', 'RXFP2', 'TSIX', 'DPYD-AS1', 'MACROD2-AS1', 'XIST', 'GDNF-AS1', 'SEMA3E', 'AP000787.1', 'TAFA1']	H18.30.001(0.7283)| H20.30.002(0.2283)| H20.30.001(0.0354)| H23.30.001(0.0079)| H19.30.004(0.0)	Balanced	Balanced	1110_B07 (0.5354)|1110_A07 (0.1772)|1042_A06 (0.1378)|1036_C03 (0.0866)|1042_B06 (0.0315)|1091_A05 (0.0157)	0.5354	1110_B07 (0.5354)|a total of 4786 cells in this dominant library	NAC(0.9961)| GPe(0.0039)| CaH(0.0)| CaT(0.0)| GPeC(0.0)| GPeR(0.0)| CaB(0.0)| GPi(0.0)| Pu(0.0)| PuC(0.0)| PuPV(0.0)| PuR(0.0)| SN(0.0)| SN-VTA(0.0)| STH(0.0)	Cautious	0	0	0	0	0	0.0137	0.0883	3463	8891.5	2.57
AIT117_200	MSN_66		AIT117_340	STRv D1 Shell	cluster							762	2	['RXFP2', 'GDNF-AS1']	['AC093515.1', 'AC079052.1', 'RXFP2', 'FAM160A1', 'GDNF-AS1', 'AC010280.1', 'SEMA3E', 'LINC01951', 'EBF1', 'TAFA1']	H20.30.002(0.6339)| H20.30.001(0.2572)| H18.30.001(0.0827)| H23.30.001(0.0262)| H19.30.004(0.0)	Balanced	Balanced	1036_C03 (0.3425)|1042_A06 (0.2677)|1042_B06 (0.1562)|1042_C06 (0.0656)|1091_A05 (0.0604)|1036_B03 (0.0315)|1036_A03 (0.0210)|1110_B07 (0.0184)	0.3425	1036_C03 (0.3425)|a total of 10219 cells in this dominant library	NAC(0.9711)| Pu(0.0079)| GPe(0.0039)| GPi(0.0039)| PuC(0.0026)| CaT(0.0026)| CaH(0.0026)| PuR(0.0026)| PuPV(0.0026)| CaB(0.0)| GPeC(0.0)| GPeR(0.0)| SN(0.0)| SN-VTA(0.0)| STH(0.0)	Cautious	0	0	0	0	0	0.01	0.2049	5746.5	21187.5	3.69
AIT117_201	MSN_67		AIT117_339	STRv D2 Shell	cluster							510	3	['AC002072.1', 'SEMA3E', 'PENK']	['AC002072.1', 'CALCRL', 'SYT10', 'SEMA3E', 'DRD2', 'PENK', 'SMOC2', 'TAFA1', 'AC008574.1', 'AC093523.1']	H20.30.002(0.6745)| H20.30.001(0.1255)| H18.30.001(0.1235)| H23.30.001(0.0765)| H19.30.004(0.0)	Balanced	Balanced	1036_C03 (0.5098)|1042_A06 (0.1294)|1110_B07 (0.0647)|1042_C06 (0.0588)|1042_B06 (0.0392)|930_B05 (0.0294)|1110_A07 (0.0235)|988_D05 (0.0216)|2006_B05 (0.0216)|2013_A01 (0.0176)|1482_A03 (0.0176)|2018_C01 (0.0118)	0.5098	1036_C03 (0.5098)|a total of 10219 cells in this dominant library	NAC(0.8353)| GPe(0.0569)| PuC(0.0294)| GPi(0.0255)| CaT(0.0235)| PuPV(0.0137)| GPeR(0.0059)| CaH(0.0059)| GPeC(0.002)| Pu(0.002)| CaB(0.0)| PuR(0.0)| SN(0.0)| SN-VTA(0.0)| STH(0.0)	Balanced	0	0	0	0	0	0.028	0.2717	4983	16411.5	3.29
AIT117_202	MSN_68		AIT117_340	STRv D1 Shell	cluster							158	3	['FAM160A1', 'GDNF-AS1', 'AL807742.1']	['TMC2', 'FAM160A1', 'GDNF-AS1', 'AL807742.1', 'XACT', 'EBF1', 'LINC01951', 'AC010997.3', 'CHD3', 'AC008574.1']	H20.30.001(0.538)| H20.30.002(0.3861)| H18.30.001(0.0506)| H23.30.001(0.0253)| H19.30.004(0.0)	Balanced	Balanced	1042_B06 (0.3544)|1036_C03 (0.3418)|1042_C06 (0.1392)|1110_B07 (0.0380)|1042_A06 (0.0316)|960_B03 (0.0253)|2006_B05 (0.0190)|1482_A03 (0.0190)|930_B05 (0.0127)	0.3544	1042_B06 (0.3544)|a total of 5839 cells in this dominant library	NAC(0.9114)| GPeR(0.0253)| GPe(0.019)| GPi(0.019)| PuC(0.0127)| CaT(0.0063)| PuPV(0.0063)| GPeC(0.0)| CaH(0.0)| CaB(0.0)| Pu(0.0)| PuR(0.0)| SN(0.0)| SN-VTA(0.0)| STH(0.0)	Balanced	0	0	0	0	0.24	0	0.3427	4124.5	11373.5	2.76
AIT117_203	MSN_69		AIT117_340	STRv D1 Shell	cluster							202	3	['LYPD1', 'TSIX', 'EBF1']	['LYPD1', 'TSIX', 'MACROD2-AS1', 'GDNF-AS1', 'EBF1', 'AC087457.1', 'TAFA1', 'AC008574.1', 'DCHS2', 'TRPC4']	H18.30.001(0.6139)| H20.30.002(0.3119)| H20.30.001(0.0545)| H23.30.001(0.0198)| H19.30.004(0.0)	Balanced	Balanced	1110_B07 (0.5198)|1036_C03 (0.2030)|1042_A06 (0.1040)|1110_A07 (0.0941)|1042_C06 (0.0198)|1482_A03 (0.0198)|1042_B06 (0.0149)	0.5198	1110_B07 (0.5198)|a total of 4786 cells in this dominant library	NAC(0.9554)| GPi(0.0248)| GPe(0.0149)| PuC(0.005)| CaH(0.0)| CaT(0.0)| CaB(0.0)| GPeR(0.0)| GPeC(0.0)| Pu(0.0)| PuPV(0.0)| PuR(0.0)| SN(0.0)| SN-VTA(0.0)| STH(0.0)	Cautious	0	0	0	0	0	0.027	0.094	4070	11775	2.89
AIT117_204	MSN_70		AIT117_340	STRv D1 Shell	cluster							587	3	['DCDC2C', 'AL359220.1', 'GDNF-AS1']	['AC093515.1', 'DCDC2C', 'FAM160A1', 'AL359220.1', 'GDNF-AS1', 'MPPED1', 'EBF1', 'TAFA1', 'AC008574.1', 'PCED1B']	H20.30.002(0.5894)| H20.30.001(0.3083)| H23.30.001(0.0579)| H18.30.001(0.0443)| H19.30.004(0.0)	Balanced	Balanced	1036_C03 (0.4276)|1042_C06 (0.1959)|1042_A06 (0.1465)|1042_B06 (0.0869)|1110_B07 (0.0256)|2016_C03 (0.0170)|2006_B05 (0.0153)|960_B03 (0.0136)|2013_A01 (0.0119)|930_B05 (0.0119)|988_D05 (0.0102)	0.4276	1036_C03 (0.4276)|a total of 10219 cells in this dominant library	NAC(0.8876)| GPe(0.0358)| GPeR(0.0204)| PuPV(0.0187)| PuC(0.0136)| CaT(0.0119)| GPi(0.0068)| CaH(0.0051)| CaB(0.0)| GPeC(0.0)| Pu(0.0)| PuR(0.0)| SN(0.0)| SN-VTA(0.0)| STH(0.0)	Balanced	0	0	0	0	0	0.0274	0.2362	6016	23048	3.83
AIT117_205	MSN_71		AIT117_339	STRv D2 Shell	cluster							363	4	['SYT10', 'GDNF-AS1', 'PENK', 'DRD2']	['DCDC2C', 'SYT10', 'GDNF-AS1', 'OPRD1', 'PENK', 'DRD2', 'KITLG', 'SMOC2', 'NNAT', 'THSD7B']	H20.30.002(0.6419)| H20.30.001(0.2507)| H18.30.001(0.0689)| H23.30.001(0.0386)| H19.30.004(0.0)	Balanced	Balanced	1036_C03 (0.4821)|1042_A06 (0.1460)|1042_C06 (0.1322)|1042_B06 (0.0854)|988_D05 (0.0441)|994_C03 (0.0275)|2016_C03 (0.0193)|1110_B07 (0.0110)	0.4821	1036_C03 (0.4821)|a total of 10219 cells in this dominant library	NAC(0.8623)| CaT(0.0441)| GPi(0.0275)| PuPV(0.0193)| GPe(0.0165)| CaH(0.0083)| PuC(0.0083)| GPeC(0.0055)| GPeR(0.0055)| Pu(0.0028)| CaB(0.0)| PuR(0.0)| SN(0.0)| SN-VTA(0.0)| STH(0.0)	Balanced	0	0	0	0	0.24	0.04	0.2456	5960	23636	3.97
AIT117_206	MSN_72		AIT117_341	STRd D1 Matrix	cluster							5875	5	['LINC00457', 'LINC02822', 'DRD1', 'EBF1', 'AP003464.1']	['LINC00457', 'AC112481.2', 'LINC02822', 'DRD1', 'EBF1', 'AP003464.1', 'TAC1', 'PRLR', 'EPB41L4A', 'LINC02112']	H20.30.002(0.4529)| H23.30.001(0.2822)| H18.30.001(0.1702)| H20.30.001(0.0946)| H19.30.004(0.0)	Balanced	Balanced	822_A01 (0.3959)|1959_C02 (0.1287)|847_B04 (0.1043)|1959_B02 (0.0912)|847_A04 (0.0555)|930_C05 (0.0526)|930_A05 (0.0424)|930_F05 (0.0274)|2006_A05 (0.0218)|1959_A02 (0.0133)	0.3959	822_A01 (0.3959)|a total of 10559 cells in this dominant library	PuR(0.5277)| CaH(0.2517)| Pu(0.1307)| CaB(0.0444)| NAC(0.0344)| PuPV(0.0034)| GPe(0.0031)| PuC(0.0022)| CaT(0.0015)| GPeC(0.0005)| GPeR(0.0003)| GPi(0.0)| SN(0.0)| SN-VTA(0.0)| STH(0.0)	Balanced	0	0	0	0	0	0.0147	0.1658	7118	35933	5.05
AIT117_207	MSN_73		AIT117_341	STRd D1 Matrix	cluster							7699	5	['AL590814.1', 'LINC02462', 'AL139379.1', 'AL138701.2', 'EBF1']	['AL590814.1', 'LINC02462', 'FER1L6-AS2', 'AL139379.1', 'AL138701.2', 'EBF1', 'TRPC6', 'TAC1', 'ADAM12', 'SOX1-OT']	H23.30.001(0.3285)| H20.30.001(0.3095)| H18.30.001(0.2864)| H20.30.002(0.0756)| H19.30.004(0.0)	Balanced	Balanced	847_A04 (0.2483)|930_C05 (0.1611)|2006_A05 (0.1411)|930_E05 (0.1290)|2013_C01 (0.0730)|1959_B02 (0.0647)|897_E03 (0.0421)|891_A06 (0.0340)|930_A05 (0.0188)|2006_B05 (0.0144)	0.2483	847_A04 (0.2483)|a total of 9215 cells in this dominant library	CaH(0.5021)| CaB(0.4191)| NAC(0.0344)| GPe(0.0216)| CaT(0.0075)| PuR(0.0058)| PuPV(0.0045)| Pu(0.0035)| PuC(0.0008)| GPeC(0.0003)| GPeR(0.0003)| GPi(0.0)| SN(0.0)| SN-VTA(0.0)| STH(0.0)	Balanced	0	0	0	0	0	0.0122	0.1108	6685	28288	4.23
AIT117_208	MSN_74		AIT117_341	STRd D1 Matrix	cluster							1652	3	['LINC01487', 'AL139042.1', 'LINC02462']	['LINC02109', 'LINC01487', 'AL590814.1', 'AL139042.1', 'AC112481.2', 'LINC02462', 'EBF1', 'TRPC6', 'ADAM12', 'PLCH1']	H20.30.002(0.7446)| H20.30.001(0.141)| H23.30.001(0.0714)| H18.30.001(0.043)| H19.30.004(0.0)	Balanced	Balanced	897_E03 (0.7367)|930_E05 (0.1314)|2013_C01 (0.0406)|891_A06 (0.0357)|2006_A05 (0.0103)	0.7367	897_E03 (0.7367)|a total of 6586 cells in this dominant library	CaB(0.9546)| CaH(0.0169)| PuPV(0.0145)| PuC(0.0048)| PuR(0.0048)| CaT(0.003)| GPe(0.0012)| GPi(0.0)| GPeR(0.0)| GPeC(0.0)| Pu(0.0)| NAC(0.0)| SN(0.0)| SN-VTA(0.0)| STH(0.0)	Cautious	0	0	0	0	0	0.02	0.0817	5608.5	23137	4.13
AIT117_209	MSN_75		AIT117_338	STRd D2 Matrix	cluster							5557	6	['LINC00457', 'LINC02343', 'LINC01378', 'ADORA2A', 'AL139379.1', 'AL138701.2']	['LINC00457', 'LINC02343', 'LINC01378', 'ADORA2A', 'AL139379.1', 'AL138701.2', 'OPRD1', 'DRD2', 'PENK', 'AP003464.1']	H20.30.002(0.5427)| H23.30.001(0.2071)| H18.30.001(0.1767)| H20.30.001(0.0734)| H19.30.004(0.0)	Balanced	Balanced	822_A01 (0.5120)|1959_B02 (0.1065)|847_A04 (0.0891)|847_B04 (0.0837)|1959_C02 (0.0614)|930_C05 (0.0516)|930_A05 (0.0209)|2006_A05 (0.0203)|930_E05 (0.0115)	0.512	822_A01 (0.512)|a total of 10559 cells in this dominant library	PuR(0.6046)| CaH(0.2712)| Pu(0.0639)| CaB(0.0452)| NAC(0.0061)| PuC(0.0036)| CaT(0.0022)| PuPV(0.0022)| GPe(0.0011)| GPeC(0.0)| GPeR(0.0)| GPi(0.0)| SN(0.0)| SN-VTA(0.0)| STH(0.0)	Balanced	0	0	0	0	0	0.01	0.1447	6950	36788	5.29
AIT117_210	MSN_76		AIT117_338	STRd D2 Matrix	cluster							1070	5	['LINC01378', 'AC068875.1', 'LINC02822', 'LINC01117', 'OTOF']	['LINC01378', 'AC068875.1', 'LINC02822', 'LINC01117', 'OTOF', 'CCDC39', 'HS3ST4', 'COL26A1', 'AL022068.1', 'YPEL1']	H23.30.001(0.7785)| H20.30.001(0.0972)| H18.30.001(0.0664)| H20.30.002(0.0579)| H19.30.004(0.0)	Balanced	Balanced	2006_B05 (0.5869)|2013_A01 (0.0832)|2006_A05 (0.0682)|847_A04 (0.0393)|1036_C03 (0.0346)|1042_C06 (0.0280)|930_C05 (0.0224)|1036_B03 (0.0150)|1042_B06 (0.0131)|1036_A03 (0.0112)|2013_C01 (0.0103)	0.5869	2006_B05 (0.5869)|a total of 6534 cells in this dominant library	GPe(0.6776)| NAC(0.1159)| CaB(0.0981)| CaH(0.072)| CaT(0.0103)| GPeR(0.0084)| PuPV(0.0075)| PuR(0.0047)| GPi(0.0028)| GPeC(0.0009)| Pu(0.0009)| PuC(0.0009)| SN(0.0)| SN-VTA(0.0)| STH(0.0)	Balanced	0	0	0	0	0	0	0.1559	4119.5	10661.5	2.59
AIT117_211	MSN_77		AIT117_338	STRd D2 Matrix	cluster							1825	5	['DDO', 'LINC02462', 'ADORA2A', 'SYT10', 'LINC01117']	['DDO', 'LINC02462', 'AC015631.1', 'ADORA2A', 'SYT10', 'LINC01117', 'DRD2', 'PENK', 'GDA', 'PCED1B']	H20.30.002(0.4192)| H20.30.001(0.3989)| H23.30.001(0.1167)| H18.30.001(0.0652)| H19.30.004(0.0)	Balanced	Balanced	1036_C03 (0.3715)|1042_C06 (0.2449)|1042_B06 (0.1074)|2006_B05 (0.0433)|1110_B07 (0.0405)|1959_B02 (0.0356)|1036_B03 (0.0345)|1042_A06 (0.0345)|2013_A01 (0.0186)|1036_A03 (0.0132)|1959_A02 (0.0110)	0.3715	1036_C03 (0.3715)|a total of 10219 cells in this dominant library	NAC(0.8696)| GPe(0.0636)| CaH(0.0493)| GPeR(0.0088)| CaB(0.0049)| GPi(0.0022)| CaT(0.0005)| GPeC(0.0005)| PuPV(0.0005)| Pu(0.0)| PuC(0.0)| PuR(0.0)| SN(0.0)| SN-VTA(0.0)| STH(0.0)	Balanced	0	0	0	0	0.39	0.02	0.1552	6411	26346	4.11
AIT117_212	MSN_78		AIT117_338	STRd D2 Matrix	cluster							1851	5	['AL138701.2', 'AC073941.1', 'AC012405.1', 'DRD2', 'PENK']	['AL139379.1', 'AL138701.2', 'AC073941.1', 'AC012405.1', 'DRD2', 'PENK', 'LOXHD1', 'THSD7B', 'EYA1', 'RBM20']	H23.30.001(0.3312)| H20.30.001(0.3171)| H18.30.001(0.2755)| H20.30.002(0.0762)| H19.30.004(0.0)	Balanced	Balanced	847_A04 (0.2339)|930_C05 (0.1561)|930_E05 (0.1178)|1959_B02 (0.0767)|2006_A05 (0.0670)|2006_B05 (0.0497)|2013_C01 (0.0416)|822_A01 (0.0373)|2013_A01 (0.0211)|1955_B06 (0.0189)|930_A05 (0.0178)|988_E05 (0.0162)|2018_B01 (0.0162)|847_B04 (0.0146)|1959_C02 (0.0140)|891_A06 (0.0135)	0.2339	847_A04 (0.2339)|a total of 9215 cells in this dominant library	CaH(0.5035)| CaB(0.2458)| GPe(0.0746)| PuR(0.0519)| NAC(0.0454)| PuPV(0.0384)| CaT(0.0194)| Pu(0.0167)| GPeR(0.0022)| PuC(0.0011)| GPeC(0.0011)| GPi(0.0)| SN(0.0)| SN-VTA(0.0)| STH(0.0)	Balanced	0	0	0	0	0.24	0.0172	0.0793	6452	28279	4.38
AIT117_213	MSN_79		AIT117_338	STRd D2 Matrix	cluster							4395	5	['AL139379.1', 'LINC02082', 'AL138701.2', 'TMEM179', 'DRD2']	['ADORA2A', 'AL139379.1', 'LINC02082', 'AL138701.2', 'TMEM179', 'DRD2', 'PENK', 'CALB1', 'SMOC2', 'SH3RF2']	H20.30.001(0.4476)| H18.30.001(0.2503)| H23.30.001(0.1845)| H20.30.002(0.1176)| H19.30.004(0.0)	Balanced	Balanced	930_C05 (0.2425)|847_A04 (0.2291)|930_E05 (0.1954)|930_A05 (0.0676)|1959_B02 (0.0585)|2013_C01 (0.0453)|2006_A05 (0.0382)|822_A01 (0.0221)|1959_A02 (0.0175)|897_E03 (0.0162)|891_A06 (0.0132)	0.2425	930_C05 (0.2425)|a total of 6153 cells in this dominant library	CaH(0.6041)| CaB(0.3083)| NAC(0.0378)| PuR(0.0246)| GPe(0.0073)| CaT(0.0061)| PuPV(0.0059)| Pu(0.0041)| PuC(0.0007)| GPeC(0.0005)| GPeR(0.0005)| GPi(0.0002)| SN(0.0)| SN-VTA(0.0)| STH(0.0)	Balanced	0	0	0	0	0	0	0.1053	6560	29361	4.48
AIT117_214	MSN_80		AIT117_343	STRd D2 Striosome	cluster							465	5	['AL353604.1', 'LINC02462', 'AC068722.1', 'AL139379.1', 'AC073941.1']	['AL353604.1', 'LINC02462', 'AC068722.1', 'CHRM3-AS2', 'AL139379.1', 'AC073941.1', 'AL138701.2', 'ETV5', 'AC012405.1', 'DRD2']	H20.30.002(0.7462)| H23.30.001(0.0925)| H20.30.001(0.0839)| H18.30.001(0.0774)| H19.30.004(0.0)	Balanced	Balanced	897_E03 (0.7312)|930_E05 (0.0753)|847_A04 (0.0409)|891_A06 (0.0366)|2006_A05 (0.0323)|2013_C01 (0.0237)|2018_B01 (0.0108)	0.7312	897_E03 (0.7312)|a total of 6586 cells in this dominant library	CaB(0.8989)| CaH(0.0473)| PuPV(0.0258)| CaT(0.0108)| GPe(0.0086)| PuR(0.0065)| PuC(0.0022)| GPi(0.0)| GPeR(0.0)| GPeC(0.0)| Pu(0.0)| NAC(0.0)| SN(0.0)| SN-VTA(0.0)| STH(0.0)	Balanced	0	0	0	0	0.39	0.02	0.0821	4820	16375	3.4
AIT117_215	MSN_81		AIT117_338	STRd D2 Matrix	cluster							1722	5	['AL590814.1', 'LINC01378', 'SOX9-AS1', 'LINC02462', 'AL139379.1']	['AL590814.1', 'LINC01378', 'SOX9-AS1', 'LINC02462', 'LINC02822', 'AL139379.1', 'AC073941.1', 'LINC01117', 'AC012405.1', 'DRD2']	H23.30.001(0.5987)| H18.30.001(0.3647)| H20.30.002(0.0226)| H20.30.001(0.0139)| H19.30.004(0.0)	Balanced	Balanced	2006_A05 (0.3328)|847_A04 (0.3235)|2013_C01 (0.1144)|1959_B02 (0.0708)|2006_B05 (0.0372)|891_A06 (0.0366)|2013_A01 (0.0273)|897_E03 (0.0174)	0.3328	2006_A05 (0.3328)|a total of 6477 cells in this dominant library	CaB(0.5075)| CaH(0.4059)| GPe(0.0645)| NAC(0.007)| PuPV(0.0058)| PuR(0.0035)| CaT(0.0029)| Pu(0.0017)| PuC(0.0006)| GPeC(0.0006)| GPeR(0.0)| GPi(0.0)| SN(0.0)| SN-VTA(0.0)| STH(0.0)	Balanced	0	0	0	0	0	0.01	0.1116	5800	19954	3.44
AIT117_216	MSN_82		AIT117_338	STRd D2 Matrix	cluster							2000	3	['LINC02343', 'LINC02462', 'LINC01378']	['LINC01487', 'LINC00457', 'LINC02343', 'AC112481.2', 'LINC02462', 'LINC01378', 'CHRM3-AS2', 'AL139379.1', 'AL138701.2', 'DRD2']	H20.30.002(0.8775)| H23.30.001(0.067)| H18.30.001(0.041)| H20.30.001(0.0145)| H19.30.004(0.0)	Balanced	Balanced	897_E03 (0.8685)|2013_C01 (0.0295)|891_A06 (0.0230)|2018_B01 (0.0135)|930_E05 (0.0125)|847_A04 (0.0120)	0.8685	897_E03 (0.8685)|a total of 6586 cells in this dominant library	CaB(0.9415)| PuPV(0.0235)| CaH(0.0145)| PuC(0.0075)| CaT(0.006)| GPe(0.0025)| PuR(0.0025)| NAC(0.002)| GPi(0.0)| GPeC(0.0)| GPeR(0.0)| Pu(0.0)| SN(0.0)| SN-VTA(0.0)| STH(0.0)	Balanced	0	0	0	0	0	0	0.0822	4346	14084.5	3.24
AIT117_217	MSN_86		AIT117_341	STRd D1 Matrix	cluster							632	2	['AL356488.2', 'AL445584.2']	['AL356488.2', 'AC159540.2', 'AC004551.1', 'TMEM179', 'AL445584.2', 'MT-ATP8', 'LINC01951', 'MT-ND4L', 'PNN', 'LINC02112']	H20.30.001(0.6013)| H23.30.001(0.1614)| H20.30.002(0.1598)| H18.30.001(0.0775)| H19.30.004(0.0)	Balanced	Balanced	930_D05 (0.2136)|930_F05 (0.1851)|988_E05 (0.1123)|930_E05 (0.0570)|2016_C03 (0.0522)|822_A01 (0.0506)|2016_B03 (0.0491)|822_B01 (0.0475)|988_D05 (0.0396)|2018_A01 (0.0253)|988_C05 (0.0174)|930_A05 (0.0158)|847_D04 (0.0158)|930_C05 (0.0142)|930_B05 (0.0127)|2013_C01 (0.0111)	0.2136	930_D05 (0.2136)|a total of 8788 cells in this dominant library	PuC(0.3165)| PuR(0.2421)| PuPV(0.2294)| CaB(0.0807)| CaT(0.0601)| CaH(0.0332)| NAC(0.0222)| GPeR(0.0095)| GPi(0.0032)| Pu(0.0016)| GPe(0.0016)| GPeC(0.0)| SN(0.0)| SN-VTA(0.0)| STH(0.0)	Balanced	0	0	0	0	0	0	0.3714	3810	10953	2.87
AIT117_218	MSN_87		AIT117_341	STRd D1 Matrix	cluster							743	4	['ATP2A3', 'AC069410.1', 'AC004551.1', 'AL445584.2']	['ATP2A3', 'AC069410.1', 'AL110292.1', 'AC004551.1', 'AL445584.2', 'LINC01951', 'SLC22A10', 'AL355472.2', 'RGS9', 'SEC14L5']	H23.30.001(0.6703)| H20.30.001(0.288)| H18.30.001(0.0215)| H20.30.002(0.0202)| H19.30.004(0.0)	Balanced	Balanced	2016_B03 (0.3069)|2016_C03 (0.2153)|988_E05 (0.1521)|930_D05 (0.0983)|2018_A01 (0.0659)|2013_C01 (0.0350)|2018_B01 (0.0336)|930_F05 (0.0296)|847_C04 (0.0135)|2006_A05 (0.0135)|930_B05 (0.0108)	0.3069	2016_B03 (0.3069)|a total of 6315 cells in this dominant library	PuC(0.4872)| PuPV(0.4145)| CaB(0.0579)| PuR(0.0296)| CaT(0.0094)| CaH(0.0013)| GPe(0.0)| GPi(0.0)| GPeR(0.0)| GPeC(0.0)| Pu(0.0)| NAC(0.0)| SN(0.0)| SN-VTA(0.0)| STH(0.0)	Balanced	0	0	0	0	0	0.027	0.0637	5771	22787	3.95
AIT117_219	MSN_88		AIT117_341	STRd D1 Matrix	cluster							6446	3	['AC069410.1', 'AL110292.1', 'LINC02822']	['ACOXL', 'AC092979.1', 'AC069410.1', 'AL110292.1', 'LINC02822', 'GREM2', 'SLC22A10', 'EBF1', 'TAC1', 'PROX1']	H20.30.001(0.4147)| H23.30.001(0.4034)| H18.30.001(0.1101)| H20.30.002(0.0718)| H19.30.004(0.0)	Balanced	Balanced	930_D05 (0.2290)|2018_A01 (0.1938)|988_E05 (0.1132)|2016_B03 (0.1126)|930_F05 (0.0627)|847_D04 (0.0603)|2018_B01 (0.0450)|847_C04 (0.0437)|988_C05 (0.0343)|2016_C03 (0.0337)|930_B05 (0.0259)|2013_C01 (0.0137)	0.229	930_D05 (0.229)|a total of 8788 cells in this dominant library	PuC(0.6216)| PuPV(0.2384)| PuR(0.0669)| CaT(0.036)| CaB(0.0281)| CaH(0.0076)| Pu(0.0008)| GPe(0.0003)| GPeC(0.0002)| GPi(0.0002)| GPeR(0.0)| NAC(0.0)| SN(0.0)| SN-VTA(0.0)| STH(0.0)	Balanced	0	0	0	0	0	0.0227	0.0801	6603.5	30841	4.67
AIT117_89	MSN_89		AIT117_342	STRd D1 Striosome	cluster							2073	4	['LINC01967', 'FAM163A', 'AC097515.1', 'AC073365.1']	['LINC01967', 'LINC01798', 'FAM163A', 'AC097515.1', 'AC073365.1', 'AC073941.1', 'AL445584.2', 'AC012405.1', 'PENK', 'RELN']	H20.30.001(0.5273)| H23.30.001(0.3579)| H18.30.001(0.0873)| H20.30.002(0.0275)| H19.30.004(0.0)	Balanced	Balanced	930_D05 (0.2243)|930_F05 (0.1438)|988_E05 (0.1394)|2016_B03 (0.1163)|2018_A01 (0.1105)|2018_B01 (0.0704)|847_D04 (0.0507)|847_C04 (0.0275)|2016_C03 (0.0270)|2013_C01 (0.0207)|930_E05 (0.0125)	0.2243	930_D05 (0.2243)|a total of 8788 cells in this dominant library	PuC(0.5094)| PuPV(0.2648)| PuR(0.1534)| CaB(0.0458)| CaH(0.0116)| CaT(0.0092)| Pu(0.0043)| NAC(0.0005)| GPe(0.0005)| GPeC(0.0005)| GPeR(0.0)| GPi(0.0)| SN(0.0)| SN-VTA(0.0)| STH(0.0)	Balanced	0	0	0	0	0.24	0.04	0.062	7478	39547	5.29
AIT117_90	MSN_90		AIT117_342	STRd D1 Striosome	cluster							566	4	['BLM', 'SPATA22', 'MCOLN3', 'LINC01798']	['BLM', 'LINC01967', 'SPATA22', 'MCOLN3', 'AL138720.1', 'LINC01798', 'LGR6', 'GPC4', 'AL390957.1', 'PTPRQ']	H20.30.001(0.4523)| H23.30.001(0.371)| H18.30.001(0.1131)| H20.30.002(0.0636)| H19.30.004(0.0)	Balanced	Balanced	930_D05 (0.2244)|2016_B03 (0.1484)|930_F05 (0.1184)|988_E05 (0.0989)|2018_B01 (0.0989)|2018_A01 (0.0901)|847_D04 (0.0565)|847_C04 (0.0477)|988_C05 (0.0389)|2016_C03 (0.0265)|822_A01 (0.0141)|930_C05 (0.0106)	0.2244	930_D05 (0.2244)|a total of 8788 cells in this dominant library	PuC(0.5265)| PuPV(0.2756)| PuR(0.1396)| CaT(0.0406)| CaH(0.0106)| CaB(0.0053)| Pu(0.0018)| GPi(0.0)| GPeR(0.0)| GPeC(0.0)| GPe(0.0)| NAC(0.0)| SN(0.0)| SN-VTA(0.0)| STH(0.0)	Balanced	0	0	0	0	0	0.05	0.0828	7665.5	42824	5.59
AIT117_91	MSN_91		AIT117_341	STRd D1 Matrix	cluster							994	5	['AL163541.1', 'AC096570.1', 'TSPAN2', 'PCAT1', 'AC016074.2']	['AL163541.1', 'AC096570.1', 'TSPAN2', 'PCAT1', 'AC016074.2', 'AL138701.2', 'AC087457.1', 'EYA1', 'KCNH5', 'MRAP2']	H20.30.001(0.6006)| H18.30.001(0.1911)| H23.30.001(0.1579)| H20.30.002(0.0503)| H19.30.004(0.0)	Balanced	Balanced	930_D05 (0.2495)|930_F05 (0.1841)|988_E05 (0.1590)|847_D04 (0.1066)|2018_A01 (0.0724)|847_C04 (0.0664)|2016_B03 (0.0493)|930_B05 (0.0241)|988_C05 (0.0161)|2018_B01 (0.0151)|2016_C03 (0.0141)	0.2495	930_D05 (0.2495)|a total of 8788 cells in this dominant library	PuC(0.502)| PuPV(0.2545)| PuR(0.1982)| CaT(0.0221)| CaB(0.0121)| CaH(0.007)| GPeC(0.003)| GPi(0.001)| GPe(0.0)| GPeR(0.0)| Pu(0.0)| NAC(0.0)| SN(0.0)| SN-VTA(0.0)| STH(0.0)	Balanced	0	0	0	0	0	0.03	0.109	6925	34140.5	4.93
AIT117_220	MSN_92		AIT117_341	STRd D1 Matrix	cluster							3419	4	['FAM163A', 'TSPAN2', 'GREM2', 'EBF1']	['FAM163A', 'TSPAN2', 'AC073941.1', 'AL445584.2', 'GREM2', 'EBF1', 'TAC1', 'MEIS1', 'RELN', 'AC008415.1']	H20.30.001(0.5294)| H23.30.001(0.2682)| H18.30.001(0.1696)| H20.30.002(0.0328)| H19.30.004(0.0)	Balanced	Balanced	930_D05 (0.2004)|930_F05 (0.1854)|988_E05 (0.1378)|2018_A01 (0.1167)|847_D04 (0.0883)|2016_B03 (0.0796)|847_C04 (0.0699)|2018_B01 (0.0380)|2016_C03 (0.0149)|2013_C01 (0.0132)	0.2004	930_D05 (0.2004)|a total of 8788 cells in this dominant library	PuC(0.4946)| PuPV(0.2612)| PuR(0.198)| CaB(0.0281)| CaT(0.0097)| CaH(0.0064)| GPe(0.0009)| GPeC(0.0009)| GPi(0.0003)| GPeR(0.0)| Pu(0.0)| NAC(0.0)| SN(0.0)| SN-VTA(0.0)| STH(0.0)	Balanced	0	0	0	0	0	0.0227	0.0915	6878	33108	4.81
AIT117_221	MSN_93		AIT117_341	STRd D1 Matrix	cluster							855	6	['ACOXL', 'FRMPD1', 'LINC01378', 'AC015631.1', 'LINC02822', 'AL139379.1']	['ACOXL', 'FRMPD1', 'LINC01378', 'AC015631.1', 'LINC02822', 'AL139379.1', 'AL138701.2', 'AL445584.2', 'LINC01951', 'EBF1']	H23.30.001(0.7532)| H20.30.001(0.1953)| H18.30.001(0.0351)| H20.30.002(0.0164)| H19.30.004(0.0)	Balanced	Balanced	2018_B01 (0.5719)|2013_C01 (0.0877)|930_D05 (0.0667)|930_F05 (0.0585)|930_E05 (0.0363)|2016_C03 (0.0269)|988_E05 (0.0269)|891_A06 (0.0246)|2016_B03 (0.0211)|2006_A05 (0.0152)|2018_A01 (0.0152)|2018_E01 (0.0129)	0.5719	2018_B01 (0.5719)|a total of 6469 cells in this dominant library	PuPV(0.6351)| CaB(0.1673)| PuC(0.1088)| PuR(0.0596)| CaT(0.0222)| CaH(0.0058)| GPe(0.0012)| GPi(0.0)| GPeR(0.0)| GPeC(0.0)| Pu(0.0)| NAC(0.0)| SN(0.0)| SN-VTA(0.0)| STH(0.0)	Balanced	0	0	0	0	0	0.0294	0.02	7345	38521	5.24
AIT117_222	MSN_94		AIT117_341	STRd D1 Matrix	cluster							885	3	['AL110292.1', 'MT-ATP8', 'DRD1']	['AL110292.1', 'TSIX', 'XIST', 'MT-ATP8', 'GREM2', 'DRD1', 'MT-ND4L', 'TAC1', 'EBF1', 'TRHDE']	H18.30.001(0.8056)| H20.30.001(0.1424)| H23.30.001(0.0429)| H20.30.002(0.009)| H19.30.004(0.0)	Balanced	Balanced	847_D04 (0.7616)|930_D05 (0.0927)|847_C04 (0.0395)|988_E05 (0.0339)|2016_B03 (0.0237)|930_F05 (0.0147)|2018_A01 (0.0113)	0.7616	847_D04 (0.7616)|a total of 3969 cells in this dominant library	PuC(0.8904)| PuPV(0.0802)| PuR(0.0226)| CaB(0.0034)| CaH(0.0023)| CaT(0.0011)| GPe(0.0)| GPi(0.0)| GPeR(0.0)| GPeC(0.0)| Pu(0.0)| NAC(0.0)| SN(0.0)| SN-VTA(0.0)| STH(0.0)	Balanced	0	0	0	0	0	0	1.4752	6754	29786	4.41
AIT117_223	MSN_95		AIT117_342	STRd D1 Striosome	cluster							338	5	['PDE4C', 'ADGRD1', 'ABO', 'RSPO3', 'SEMA3C']	['PDE4C', 'ADGRD1', 'ABO', 'RSPO3', 'LINC01435', 'SEMA3C', 'IL1RAPL2', 'EBF1', 'SLCO5A1', 'SEMA3E']	H23.30.001(0.6568)| H18.30.001(0.1716)| H20.30.001(0.1183)| H20.30.002(0.0533)| H19.30.004(0.0)	Balanced	Balanced	2018_C01 (0.2870)|2018_B01 (0.1864)|988_D05 (0.1509)|2018_E01 (0.0503)|2013_C01 (0.0414)|930_E05 (0.0414)|822_B01 (0.0414)|988_E05 (0.0355)|980_C02 (0.0325)|2006_B05 (0.0266)|2016_B03 (0.0178)|2012_C05 (0.0178)|2016_C03 (0.0148)|988_C05 (0.0118)|891_A06 (0.0118)	0.287	2018_C01 (0.287)|a total of 7029 cells in this dominant library	GPe(0.3195)| PuPV(0.2781)| CaT(0.2633)| CaB(0.1036)| PuC(0.0207)| CaH(0.0059)| NAC(0.0059)| GPeC(0.003)| GPeR(0.0)| GPi(0.0)| Pu(0.0)| PuR(0.0)| SN(0.0)| SN-VTA(0.0)| STH(0.0)	Balanced	0	0	0	0	0	0.053	0.038	8119	50024	6.16
AIT117_224	MSN_96		AIT117_342	STRd D1 Striosome	cluster							453	4	['TH', 'EBF1', 'TRPC6', 'COL4A2']	['TH', 'FAM9B', 'AC025887.2', 'EBF1', 'TRPC6', 'COL4A2', 'RELN', 'ETV1', 'PCDH11Y', 'BICC1']	H23.30.001(0.7196)| H20.30.001(0.0993)| H18.30.001(0.0927)| H20.30.002(0.0883)| H19.30.004(0.0)	Balanced	Balanced	2018_C01 (0.4216)|2016_C03 (0.1104)|2006_B05 (0.0640)|1036_C03 (0.0596)|2013_A01 (0.0530)|988_D05 (0.0486)|1042_C06 (0.0442)|1042_B06 (0.0353)|2013_C01 (0.0221)|1110_B07 (0.0177)|1110_A07 (0.0155)|2012_A05 (0.0132)|988_E05 (0.0132)|2018_B01 (0.0110)|822_B01 (0.0110)	0.4216	2018_C01 (0.4216)|a total of 7029 cells in this dominant library	GPe(0.5519)| NAC(0.181)| PuPV(0.1457)| CaT(0.0618)| CaB(0.0287)| PuC(0.0177)| GPi(0.0066)| GPeR(0.0022)| GPeC(0.0022)| CaH(0.0022)| Pu(0.0)| PuR(0.0)| SN(0.0)| SN-VTA(0.0)| STH(0.0)	Balanced	0	0	0	0	0.24	0.0538	0.0571	7512	40965	5.45
AIT117_225	MSN_97		AIT117_342	STRd D1 Striosome	cluster							513	6	['AC025887.2', 'AC015631.1', 'MCTP2', 'GDNF-AS1', 'TMEM44', 'EBF1']	['AC025887.2', 'AC015631.1', 'MCTP2', 'GDNF-AS1', 'TMEM44', 'EBF1', 'LOXHD1', 'AC011246.1', 'SEMA5B', 'RELN']	H23.30.001(0.5146)| H18.30.001(0.2495)| H20.30.002(0.1306)| H20.30.001(0.1053)| H19.30.004(0.0)	Balanced	Balanced	988_D05 (0.2144)|2018_C01 (0.2144)|822_B01 (0.0877)|2016_C03 (0.0741)|2018_B01 (0.0682)|988_E05 (0.0643)|2018_E01 (0.0546)|2013_C01 (0.0409)|2016_B03 (0.0351)|930_E05 (0.0214)|891_A06 (0.0195)|930_B05 (0.0175)|980_C02 (0.0156)|988_C05 (0.0136)|853_B07 (0.0117)	0.2144	988_D05 (0.2144)|a total of 8686 cells in this dominant library	CaT(0.308)| PuPV(0.2963)| GPe(0.23)| CaB(0.0838)| PuC(0.0526)| GPeC(0.0117)| NAC(0.0117)| PuR(0.0039)| GPeR(0.0019)| GPi(0.0)| CaH(0.0)| Pu(0.0)| SN(0.0)| SN-VTA(0.0)| STH(0.0)	Balanced	0	0	0	0	0.39	0.0538	0.0572	8003	48089	6.01
AIT117_226	MSN_98		AIT117_341	STRd D1 Matrix	cluster							2007	4	['RASGRF2-AS1', 'LINC02462', 'FER1L6-AS2', 'GDNF-AS1']	['AP003121.1', 'RASGRF2-AS1', 'AC002066.1', 'LINC02462', 'FER1L6-AS2', 'GDNF-AS1', 'TAC1', 'SNTG2', 'SEMA5B', 'ADAM12']	H20.30.001(0.85)| H23.30.001(0.0772)| H18.30.001(0.0563)| H20.30.002(0.0164)| H19.30.004(0.0)	Balanced	Balanced	980_C02 (0.8291)|2018_E01 (0.0409)|988_D05 (0.0384)|2012_C05 (0.0239)|891_A06 (0.0179)|988_E05 (0.0140)	0.8291	980_C02 (0.8291)|a total of 6906 cells in this dominant library	CaT(0.9332)| CaB(0.0299)| PuPV(0.0299)| GPe(0.0025)| NAC(0.0015)| PuC(0.0015)| CaH(0.001)| PuR(0.0005)| GPi(0.0)| GPeC(0.0)| GPeR(0.0)| Pu(0.0)| SN(0.0)| SN-VTA(0.0)| STH(0.0)	Balanced	0	0	0	0	0.24	0.1	0.0635	6723	25992	3.87
AIT117_227	MSN_99		AIT117_341	STRd D1 Matrix	cluster							2215	6	['AP003121.1', 'AP001993.1', 'LINC02712', 'AC015631.1', 'LINC02462', 'FER1L6-AS2']	['AP003121.1', 'AP001993.1', 'LINC02712', 'AC015631.1', 'LINC02462', 'FER1L6-AS2', 'MCTP2', 'AL445584.2', 'AC011246.1', 'GLI3']	H23.30.001(0.7946)| H20.30.001(0.1187)| H18.30.001(0.0646)| H20.30.002(0.0221)| H19.30.004(0.0)	Balanced	Balanced	2018_E01 (0.4126)|2012_C05 (0.1828)|2018_B01 (0.1508)|980_C02 (0.0993)|988_D05 (0.0442)|2016_C03 (0.0217)|891_A06 (0.0190)|822_B01 (0.0158)|2013_C01 (0.0158)|988_E05 (0.0144)	0.4126	2018_E01 (0.4126)|a total of 6375 cells in this dominant library	CaT(0.7395)| PuPV(0.2027)| CaB(0.0433)| GPe(0.0068)| CaH(0.0023)| PuC(0.0023)| PuR(0.0014)| NAC(0.0009)| Pu(0.0005)| GPeC(0.0005)| GPeR(0.0)| GPi(0.0)| SN(0.0)| SN-VTA(0.0)| STH(0.0)	Balanced	0	0	0	0	0	0.0267	0.0262	7223	34524	4.78
AIT117_228	MSN_100		AIT117_341	STRd D1 Matrix	cluster							1825	4	['AP003121.1', 'FAM163A', 'FRMPD1', 'AC015631.1']	['AP003121.1', 'FAM163A', 'LINC02712', 'FRMPD1', 'AC015631.1', 'LINC02462', 'FER1L6-AS2', 'MCTP2', 'EBF1', 'AL591501.1']	H23.30.001(0.28)| H18.30.001(0.2559)| H20.30.002(0.2351)| H20.30.001(0.229)| H19.30.004(0.0)	Balanced	Balanced	988_D05 (0.2521)|822_B01 (0.2022)|988_E05 (0.1879)|2016_C03 (0.1195)|2018_B01 (0.0926)|980_C02 (0.0356)|2018_E01 (0.0279)|930_B05 (0.0208)|2013_C01 (0.0110)	0.2521	988_D05 (0.2521)|a total of 8686 cells in this dominant library	PuPV(0.6027)| CaT(0.3266)| PuC(0.0307)| CaB(0.0186)| GPe(0.0137)| PuR(0.0038)| GPi(0.0022)| CaH(0.0005)| GPeR(0.0005)| Pu(0.0005)| GPeC(0.0)| NAC(0.0)| SN(0.0)| SN-VTA(0.0)| STH(0.0)	Balanced	0	0	0	0	0	0.04	0.1099	7363	39229	5.33
AIT117_229	MSN_101		AIT117_341	STRd D1 Matrix	cluster							453	3	['AP003121.1', 'FER1L6-AS2', 'TMEM44']	['AP003121.1', 'AP001993.1', 'LINC02712', 'AC015631.1', 'FER1L6-AS2', 'TMEM44', 'AC011246.1', 'AL591501.1', 'LINC02137', 'AL355472.2']	H23.30.001(0.7373)| H20.30.001(0.1656)| H18.30.001(0.0751)| H20.30.002(0.0221)| H19.30.004(0.0)	Balanced	Balanced	2016_C03 (0.5320)|980_C02 (0.0883)|988_D05 (0.0728)|2018_E01 (0.0662)|988_E05 (0.0640)|2018_B01 (0.0464)|2012_C05 (0.0442)|2006_B05 (0.0177)|822_B01 (0.0155)|2013_C01 (0.0132)	0.532	2016_C03 (0.532)|a total of 8224 cells in this dominant library	PuPV(0.6578)| CaT(0.2715)| GPe(0.0287)| CaB(0.0243)| PuC(0.0066)| NAC(0.0044)| CaH(0.0022)| GPi(0.0022)| PuR(0.0022)| GPeR(0.0)| GPeC(0.0)| Pu(0.0)| SN(0.0)| SN-VTA(0.0)| STH(0.0)	Balanced	0	0	0	0	0	0.08	0.0781	5259	18110	3.44
AIT117_102	MSN_102		AIT117_340	STRv D1 Shell	cluster							2884	4	['AC002066.1', 'NPFFR2', 'XIST', 'MCTP2']	['AC002066.1', 'NPFFR2', 'AC015631.1', 'XIST', 'LINC02822', 'MCTP2', 'TESPA1', 'EBF1', 'TAC1', 'MT-ND4L']	H18.30.001(0.5423)| H23.30.001(0.2552)| H20.30.001(0.111)| H20.30.002(0.0915)| H19.30.004(0.0)	Balanced	Balanced	988_D05 (0.5246)|2016_C03 (0.1779)|988_E05 (0.0829)|822_B01 (0.0524)|930_B05 (0.0229)|2018_B01 (0.0205)|980_C02 (0.0160)|2013_A01 (0.0139)	0.5246	988_D05 (0.5246)|a total of 8686 cells in this dominant library	CaT(0.5544)| PuPV(0.3367)| PuC(0.0326)| GPe(0.0316)| NAC(0.0139)| CaB(0.008)| GPi(0.0076)| GPeC(0.0066)| GPeR(0.0066)| PuR(0.001)| Pu(0.0007)| CaH(0.0003)| SN(0.0)| SN-VTA(0.0)| STH(0.0)	Balanced	0	0	0	0	0.39	0.04	0.2437	6829	29366	4.3
AIT117_103	MSN_103		AIT117_340	STRv D1 Shell	cluster							499	4	['FAM9B', 'MKX', 'GDNF-AS1', 'TESPA1']	['CAV1', 'FAM9B', 'MKX', 'GDNF-AS1', 'MYO1B', 'TESPA1', 'COL4A2', 'ZNF423', 'PCDH11Y', 'BICC1']	H23.30.001(0.7335)| H18.30.001(0.1583)| H20.30.001(0.0681)| H20.30.002(0.0401)| H19.30.004(0.0)	Balanced	Balanced	2016_C03 (0.3727)|2018_C01 (0.3206)|988_D05 (0.1583)|988_E05 (0.0321)|980_C02 (0.0301)|930_B05 (0.0240)|822_B01 (0.0140)|2013_C01 (0.0140)	0.3727	2016_C03 (0.3727)|a total of 8224 cells in this dominant library	PuPV(0.4248)| GPe(0.3327)| CaT(0.1944)| PuC(0.024)| CaB(0.016)| NAC(0.006)| GPi(0.002)| GPeR(0.0)| GPeC(0.0)| CaH(0.0)| Pu(0.0)| PuR(0.0)| SN(0.0)| SN-VTA(0.0)| STH(0.0)	Balanced	0	0	0	0	0.39	0.1183	0.067	7633	43354	5.68
AIT117_104	MSN_104		AIT117_339	STRv D2 Shell	cluster							359	3	['MOXD1', 'ADAMTS18', 'CALCRL']	['LINC00390', 'MOXD1', 'ADAMTS18', 'NEB', 'AC015631.1', 'CALCRL', 'AC087564.1', 'AC008574.1', 'NELL1', 'SEMA5A']	H23.30.001(0.8301)| H20.30.002(0.0808)| H18.30.001(0.0752)| H20.30.001(0.0139)| H19.30.004(0.0)	Balanced	Balanced	2016_C03 (0.7939)|930_B05 (0.0780)|988_D05 (0.0641)|2018_C01 (0.0167)|2013_C01 (0.0111)	0.7939	2016_C03 (0.7939)|a total of 8224 cells in this dominant library	PuPV(0.7967)| PuC(0.078)| CaT(0.0696)| GPe(0.0195)| NAC(0.0167)| CaB(0.0167)| GPi(0.0028)| GPeR(0.0)| GPeC(0.0)| CaH(0.0)| Pu(0.0)| PuR(0.0)| SN(0.0)| SN-VTA(0.0)| STH(0.0)	Balanced	0	0	0	0	0	0.09	0.155	5956	25397	4.26
AIT117_105	MSN_105		AIT117_339	STRv D2 Shell	cluster							76	3	['FREM2', 'GABRG1', 'SYNJ2']	['FREM2', 'FAM160A1', 'SEMA3D', 'ADAMTSL1', 'GABRG1', 'SYNJ2', 'GDA', 'ANKRD34B', 'TRPC4', 'SEMA5A']	H20.30.001(0.7763)| H23.30.001(0.1711)| H20.30.002(0.0526)| H18.30.001(0.0)| H19.30.004(0.0)	Balanced	Balanced	1482_A03 (0.7763)|2018_C01 (0.0789)|2013_A01 (0.0395)|988_C05 (0.0263)|1959_B02 (0.0132)|1959_C02 (0.0132)|2016_C03 (0.0132)|1036_C03 (0.0132)|2012_B05 (0.0132)|930_B05 (0.0132)	0.7763	1482_A03 (0.7763)|a total of 4968 cells in this dominant library	GPi(0.7895)| GPe(0.1184)| CaT(0.0263)| CaH(0.0132)| PuC(0.0132)| Pu(0.0132)| NAC(0.0132)| PuPV(0.0132)| GPeR(0.0)| CaB(0.0)| GPeC(0.0)| PuR(0.0)| SN(0.0)| SN-VTA(0.0)| STH(0.0)	Balanced	0	0	0	0	0	0.1	0.0989	8338	65434.5	7.85
AIT117_230	MSN_106		AIT117_339	STRv D2 Shell	cluster							655	3	['DCDC2C', 'LINC02462', 'COL4A1']	['LINC00390', 'DCDC2C', 'AC015631.1', 'CACNG5', 'LINC02462', 'COL4A1', 'POU6F2', 'PENK', 'SLC24A4', 'SPHKAP']	H23.30.001(0.5267)| H18.30.001(0.2183)| H20.30.002(0.142)| H20.30.001(0.113)| H19.30.004(0.0)	Balanced	Balanced	2016_C03 (0.4412)|988_D05 (0.2153)|930_B05 (0.0840)|980_C02 (0.0748)|2018_C01 (0.0443)|822_B01 (0.0321)|1036_C03 (0.0168)|1482_A03 (0.0153)|2013_C01 (0.0153)|1042_B06 (0.0137)|2018_B01 (0.0122)	0.4412	2016_C03 (0.4412)|a total of 8224 cells in this dominant library	PuPV(0.4855)| CaT(0.2947)| PuC(0.084)| GPe(0.0504)| NAC(0.0458)| GPi(0.0168)| CaB(0.0168)| PuR(0.0015)| GPeR(0.0015)| GPeC(0.0015)| Pu(0.0015)| CaH(0.0)| SN(0.0)| SN-VTA(0.0)| STH(0.0)	Balanced	0	0	0	0	0	0.06	0.2509	5380	19389	3.6
AIT117_231	MSN_107		AIT117_343	STRd D2 Striosome	cluster							2198	3	['PTH2R', 'AL353604.1', 'NDST4']	['AC002066.1', 'PTH2R', 'AL353604.1', 'AC015631.1', 'NDST4', 'FAT1', 'DRD2', 'PENK', 'SLC24A4', 'RELN']	H23.30.001(0.4054)| H18.30.001(0.364)| H20.30.002(0.1174)| H20.30.001(0.1133)| H19.30.004(0.0)	Balanced	Balanced	988_D05 (0.3585)|2018_C01 (0.1770)|2016_C03 (0.1611)|822_B01 (0.0660)|988_E05 (0.0628)|930_B05 (0.0423)|2018_B01 (0.0287)|1482_A03 (0.0159)	0.3585	988_D05 (0.3585)|a total of 8686 cells in this dominant library	CaT(0.3722)| PuPV(0.3185)| GPe(0.1979)| PuC(0.0446)| GPi(0.0237)| NAC(0.0209)| CaB(0.0105)| GPeR(0.01)| GPeC(0.0018)| CaH(0.0)| Pu(0.0)| PuR(0.0)| SN(0.0)| SN-VTA(0.0)| STH(0.0)	Balanced	0	0	0	0	0.24	0.0526	0.1421	6143	26318.5	4.28
AIT117_232	MSN_108		AIT117_338	STRd D2 Matrix	cluster							3182	4	['LINC02822', 'CALCRL', 'DRD2', 'NDST4']	['AC015631.1', 'LINC02462', 'LINC02822', 'CALCRL', 'DRD2', 'NDST4', 'KITLG', 'SLC24A4', 'SPHKAP', 'GLI3']	H18.30.001(0.4532)| H23.30.001(0.1892)| H20.30.002(0.1892)| H20.30.001(0.1684)| H19.30.004(0.0)	Balanced	Balanced	988_D05 (0.4387)|988_E05 (0.1427)|2016_C03 (0.1301)|822_B01 (0.1128)|930_B05 (0.0704)|2018_B01 (0.0229)|980_C02 (0.0173)	0.4387	988_D05 (0.4387)|a total of 8686 cells in this dominant library	CaT(0.4645)| PuPV(0.4111)| PuC(0.0811)| GPe(0.0176)| GPeC(0.006)| CaB(0.0057)| GPeR(0.005)| NAC(0.0041)| PuR(0.0019)| GPi(0.0016)| CaH(0.0016)| Pu(0.0)| SN(0.0)| SN-VTA(0.0)| STH(0.0)	Balanced	0	0	0	0	0	0.0227	0.2096	5714.5	21662.5	3.79
AIT117_233	MSN_109		AIT117_338	STRd D2 Matrix	cluster							2380	3	['AL627171.2', 'PENK', 'LOXHD1']	['LINC02462', 'GRB14', 'AL627171.2', 'PENK', 'DRD2', 'LOXHD1', 'FAT1', 'NOS1', 'THSD4', 'HS3ST4']	H20.30.001(0.7697)| H23.30.001(0.1735)| H18.30.001(0.0441)| H20.30.002(0.0126)| H19.30.004(0.0)	Balanced	Balanced	980_C02 (0.7071)|2018_E01 (0.0920)|988_E05 (0.0471)|988_D05 (0.0349)|2018_B01 (0.0303)|2012_C05 (0.0282)|930_E05 (0.0130)|822_B01 (0.0101)	0.7071	980_C02 (0.7071)|a total of 6906 cells in this dominant library	CaT(0.8626)| PuPV(0.0962)| CaB(0.0319)| GPe(0.0038)| CaH(0.0021)| NAC(0.0021)| GPeC(0.0004)| PuC(0.0004)| PuR(0.0004)| GPi(0.0)| GPeR(0.0)| Pu(0.0)| SN(0.0)| SN-VTA(0.0)| STH(0.0)	Balanced	0	0	0	0	0	0.07	0.0473	5916	21668	3.66
AIT117_234	MSN_110		AIT117_338	STRd D2 Matrix	cluster							1985	6	['RMRP', 'AC015631.1', 'AL138701.2', 'OPRD1', 'MT-ATP8', 'DRD2']	['RMRP', 'AC015631.1', 'AL138701.2', 'OPRD1', 'MT-ATP8', 'DRD2', 'GLI3', 'NOS1', 'SNTG2', 'AC107208.1']	H20.30.002(0.5975)| H18.30.001(0.1834)| H20.30.001(0.1295)| H23.30.001(0.0897)| H19.30.004(0.0)	Balanced	Balanced	822_B01 (0.5310)|988_D05 (0.1768)|988_E05 (0.1113)|930_B05 (0.0433)|2016_C03 (0.0358)|2018_E01 (0.0287)|988_C05 (0.0166)|2018_B01 (0.0131)|980_C02 (0.0101)	0.531	822_B01 (0.531)|a total of 6920 cells in this dominant library	PuPV(0.6922)| CaT(0.2353)| PuC(0.0443)| CaB(0.0171)| GPe(0.0065)| CaH(0.002)| GPi(0.001)| PuR(0.001)| NAC(0.0005)| GPeR(0.0)| GPeC(0.0)| Pu(0.0)| SN(0.0)| SN-VTA(0.0)| STH(0.0)	Balanced	0	0	0	0	0	0.0227	0.1695	7392	50235	6.8
AIT117_235	MSN_111		AIT117_338	STRd D2 Matrix	cluster							2970	5	['LINC01378', 'AC015631.1', 'LINC02462', 'ADORA2A', 'AL627171.2']	['LINC01378', 'AC015631.1', 'LINC02462', 'ADORA2A', 'AL627171.2', 'DRD2', 'PENK', 'LINC01515', 'GLI3', 'NOS1']	H23.30.001(0.7916)| H20.30.001(0.0926)| H18.30.001(0.0906)| H20.30.002(0.0253)| H19.30.004(0.0)	Balanced	Balanced	2018_E01 (0.2805)|2018_B01 (0.2222)|2012_C05 (0.1219)|2016_C03 (0.0983)|988_D05 (0.0609)|980_C02 (0.0599)|2013_C01 (0.0458)|988_E05 (0.0266)|891_A06 (0.0232)|822_B01 (0.0185)	0.2805	2018_E01 (0.2805)|a total of 6375 cells in this dominant library	CaT(0.5236)| PuPV(0.3667)| CaB(0.0801)| GPe(0.0098)| PuC(0.0088)| CaH(0.0064)| GPi(0.0013)| PuR(0.001)| GPeC(0.001)| NAC(0.0007)| Pu(0.0007)| GPeR(0.0)| SN(0.0)| SN-VTA(0.0)| STH(0.0)	Balanced	0	0	0	0	0	0.0241	0.0321	5944.5	21807.5	3.67
AIT117_236	MSN_112		AIT117_338	STRd D2 Matrix	cluster							7060	4	['STRIT1', 'TESPA1', 'DRD2', 'GPR88']	['STRIT1', 'TESPA1', 'OPRD1', 'DRD2', 'PENK', 'GPR88', 'SNTG2', 'ARHGAP10', 'ADAM12', 'GRIK3']	H20.30.001(0.6846)| H23.30.001(0.1895)| H18.30.001(0.1048)| H20.30.002(0.0211)| H19.30.004(0.0)	Balanced	Balanced	930_D05 (0.3166)|988_E05 (0.1899)|930_F05 (0.1630)|2018_A01 (0.0858)|2016_B03 (0.0525)|847_C04 (0.0487)|847_D04 (0.0470)|2018_B01 (0.0279)|2016_C03 (0.0125)	0.3166	930_D05 (0.3166)|a total of 8788 cells in this dominant library	PuC(0.5076)| PuPV(0.2807)| PuR(0.171)| CaB(0.0271)| CaH(0.0092)| CaT(0.0033)| GPe(0.0007)| GPeC(0.0003)| Pu(0.0001)| GPi(0.0)| GPeR(0.0)| NAC(0.0)| SN(0.0)| SN-VTA(0.0)| STH(0.0)	Balanced	0	0	0	0	0	0.02	0.0965	5938	25800.5	4.35
AIT117_237	MSN_113		AIT117_338	STRd D2 Matrix	cluster							5188	3	['ATP2A3', 'LINC01378', 'DRD2']	['ATP2A3', 'STRIT1', 'LINC01378', 'ADORA2A', 'LINC02822', 'DRD2', 'SLC22A10', 'GPR88', 'SNTG2', 'ARHGAP10']	H23.30.001(0.7103)| H18.30.001(0.2043)| H20.30.001(0.069)| H20.30.002(0.0164)| H19.30.004(0.0)	Balanced	Balanced	2018_A01 (0.2891)|2016_B03 (0.2195)|847_C04 (0.1243)|2016_C03 (0.0873)|2018_B01 (0.0675)|847_D04 (0.0673)|2013_C01 (0.0324)|930_D05 (0.0268)|930_F05 (0.0247)|988_E05 (0.0148)|2006_A05 (0.0120)	0.2891	2018_A01 (0.2891)|a total of 7432 cells in this dominant library	PuC(0.6097)| PuPV(0.2957)| CaB(0.0532)| PuR(0.0312)| CaT(0.006)| CaH(0.0025)| GPe(0.0012)| Pu(0.0004)| GPeC(0.0002)| GPi(0.0)| GPeR(0.0)| NAC(0.0)| SN(0.0)| SN-VTA(0.0)| STH(0.0)	Balanced	0	0	0	0	0	0	0.0735	5942.5	21919	3.69
AIT117_238	MSN_114		AIT117_338	STRd D2 Matrix	cluster							1383	4	['LINC01487', 'OPRD1', 'SLC22A10', 'SNTG2']	['LINC01487', 'TBL1Y', 'OPRD1', 'SLC22A10', 'DRD2', 'SNTG2', 'AC107208.1', 'SDK2', 'GRIK3', 'AL355472.2']	H20.30.002(0.7592)| H18.30.001(0.12)| H23.30.001(0.0615)| H20.30.001(0.0593)| H19.30.004(0.0)	Balanced	Balanced	930_B05 (0.3977)|988_C05 (0.3341)|847_D04 (0.0571)|847_C04 (0.0456)|2016_B03 (0.0304)|2016_C03 (0.0275)|930_D05 (0.0253)|988_E05 (0.0210)|822_B01 (0.0159)|988_D05 (0.0130)|930_F05 (0.0123)	0.3977	930_B05 (0.3977)|a total of 2428 cells in this dominant library	PuC(0.5134)| CaT(0.3471)| PuPV(0.1099)| PuR(0.0217)| GPeC(0.0036)| CaB(0.0029)| CaH(0.0007)| GPe(0.0007)| GPeR(0.0)| GPi(0.0)| Pu(0.0)| NAC(0.0)| SN(0.0)| SN-VTA(0.0)| STH(0.0)	Balanced	0	0	0	0	0	0	0.2109	6604	38795	5.87
AIT117_115	MSN_115		AIT117_338	STRd D2 Matrix	cluster							502	5	['MT-ND6', 'AC112481.2', 'TSIX', 'LINC01378', 'ADORA2A']	['MT-ND6', 'AC112481.2', 'TSIX', 'GPR6', 'LINC01378', 'ADORA2A', 'XIST', 'MT-ATP8', 'MT-ND4L', 'DRD2']	H18.30.001(0.8865)| H20.30.001(0.0857)| H20.30.002(0.0139)| H23.30.001(0.0139)| H19.30.004(0.0)	Balanced	Balanced	847_D04 (0.7908)|847_C04 (0.0896)|930_D05 (0.0618)|930_F05 (0.0179)	0.7908	847_D04 (0.7908)|a total of 3969 cells in this dominant library	PuC(0.8665)| PuPV(0.1036)| PuR(0.0239)| CaT(0.004)| GPeC(0.002)| CaH(0.0)| CaB(0.0)| GPi(0.0)| GPeR(0.0)| GPe(0.0)| Pu(0.0)| NAC(0.0)| SN(0.0)| SN-VTA(0.0)| STH(0.0)	Balanced	0	0	0	0	0	0	1.6359	6465.5	27185.5	4.2
AIT117_116	MSN_116		AIT117_338	STRd D2 Matrix	cluster							337	4	['TBL1Y', 'MT-ATP8', 'MT-ND4L', 'DRD2']	['GRB14', 'TBL1Y', 'MT-ATP8', 'MT-ND4L', 'DRD2', 'GPR88', 'SNTG2', 'ARHGAP10', 'KCNAB1', 'MTRNR2L12']	H20.30.001(0.8605)| H18.30.001(0.1395)| H19.30.004(0.0)| H20.30.002(0.0)| H23.30.001(0.0)	Balanced	Balanced	930_D05 (0.5252)|988_E05 (0.2849)|847_D04 (0.1306)|930_F05 (0.0415)	0.5252	930_D05 (0.5252)|a total of 8788 cells in this dominant library	PuC(0.6558)| PuPV(0.2908)| PuR(0.0415)| CaB(0.0059)| CaH(0.003)| CaT(0.003)| GPe(0.0)| GPi(0.0)| GPeR(0.0)| GPeC(0.0)| Pu(0.0)| NAC(0.0)| SN(0.0)| SN-VTA(0.0)| STH(0.0)	Balanced	0	0	0	0	0	0.04	1.5531	4998	18586	3.72
AIT117_117	MSN_117		AIT117_338	STRd D2 Matrix	cluster							1971	6	['AL353604.1', 'AL139379.1', 'AC073941.1', 'OPRD1', 'AC012405.1', 'DRD2']	['AL353604.1', 'AL139379.1', 'AC073941.1', 'OPRD1', 'AC012405.1', 'DRD2', 'LOXHD1', 'PENK', 'CNKSR3', 'ARHGAP10']	H20.30.001(0.5185)| H23.30.001(0.3186)| H18.30.001(0.1182)| H20.30.002(0.0446)| H19.30.004(0.0)	Balanced	Balanced	930_D05 (0.2116)|988_E05 (0.1492)|930_F05 (0.1350)|2018_B01 (0.0928)|2016_B03 (0.0807)|2018_A01 (0.0660)|847_C04 (0.0609)|2016_C03 (0.0345)|847_D04 (0.0335)|2013_C01 (0.0249)|822_A01 (0.0203)|930_E05 (0.0162)|897_E03 (0.0132)	0.2116	930_D05 (0.2116)|a total of 8788 cells in this dominant library	PuC(0.3962)| PuPV(0.3404)| PuR(0.1639)| CaB(0.068)| CaH(0.0122)| CaT(0.0117)| Pu(0.0036)| GPe(0.0025)| GPeC(0.001)| GPi(0.0005)| GPeR(0.0)| NAC(0.0)| SN(0.0)| SN-VTA(0.0)| STH(0.0)	Balanced	0	0	0	0	0.5	0.0263	0.0783	6307	27961	4.43
AIT117_118	MSN_118		AIT117_338	STRd D2 Matrix	cluster							513	2	['AC004551.1', 'DRD2']	['AC244131.2', 'AC004551.1', 'TMEM179', 'OPRD1', 'DRD2', 'SNTG2', 'PNN', 'ARHGAP10', 'CCDC39', 'AC092902.4']	H20.30.001(0.768)| H23.30.001(0.152)| H20.30.002(0.0546)| H18.30.001(0.0253)| H19.30.004(0.0)	Balanced	Balanced	930_D05 (0.3041)|988_E05 (0.2632)|930_F05 (0.1540)|2016_B03 (0.0624)|2016_C03 (0.0624)|930_E05 (0.0390)|930_B05 (0.0175)|897_E03 (0.0136)|988_C05 (0.0117)|847_D04 (0.0117)	0.3041	930_D05 (0.3041)|a total of 8788 cells in this dominant library	PuC(0.4055)| PuPV(0.3372)| PuR(0.1618)| CaB(0.0682)| CaT(0.0175)| CaH(0.0078)| NAC(0.0019)| GPi(0.0)| GPeR(0.0)| GPeC(0.0)| GPe(0.0)| Pu(0.0)| SN(0.0)| SN-VTA(0.0)| STH(0.0)	Balanced	0	0	0	0	0	0.0143	0.1928	3699	10903	2.95
AIT117_239	NN_1		AIT117_348	BN Astrocyte	cluster							3024	4	['LINC01088', 'EDNRB', 'APOE', 'SLC6A11']	['STK32A', 'LINC01088', 'EDNRB', 'TNC', 'APOE', 'SLC6A11', 'OBI1-AS1', 'HPSE2', 'AC012405.1', 'TIMP3']	H23.30.001(0.3234)| H20.30.002(0.2269)| H20.30.001(0.2017)| H18.30.001(0.1462)| H19.30.004(0.1019)	Balanced	Balanced	960_B03 (0.0939)|2012_B05 (0.0893)|1468_A09 (0.0840)|1477_A07 (0.0777)|1001_B06 (0.0694)|858_D03 (0.0585)|2012_A05 (0.0546)|2013_A01 (0.0450)|994_C03 (0.0443)|1458_A09 (0.0417)|2016_A03 (0.0413)|925_F03 (0.0407)|1482_A03 (0.0367)|2013_B01 (0.0304)|1169_A01 (0.0271)|1075_B04 (0.0251)|2058_B03 (0.0212)|2006_B05 (0.0165)|2018_C01 (0.0155)|988_E05 (0.0132)|1001_A06 (0.0126)|853_A07 (0.0112)	0.0939	960_B03 (0.0939)|a total of 3661 cells in this dominant library	GPi(0.381)| STH(0.2169)| GPe(0.1316)| GPeR(0.1052)| SN-VTA(0.082)| SN(0.0423)| PuPV(0.0155)| NAC(0.0093)| GPeC(0.0069)| CaT(0.004)| CaB(0.0026)| PuC(0.002)| Pu(0.0003)| PuR(0.0003)| CaH(0.0)	Balanced	0	0	0	0	0	0.0141	0.0477	2560	5366.5	2.1
AIT117_240	NN_2		AIT117_348	BN Astrocyte	cluster							2328	3	['LINC00906', 'CPAMD8', 'LINC00836']	['LINC00906', 'AL355612.1', 'FAP', 'AL627316.1', 'CPAMD8', 'LINC00836', 'LINC01088', 'CD44', 'SLC14A1', 'TNC']	H23.30.001(0.3694)| H18.30.001(0.2521)| H20.30.002(0.1602)| H19.30.004(0.1125)| H20.30.001(0.1057)	Balanced	Balanced	1075_B04 (0.1284)|2012_A05 (0.0777)|1477_A07 (0.0752)|858_D03 (0.0735)|2058_B03 (0.0610)|1468_A09 (0.0606)|2016_A03 (0.0524)|1001_B06 (0.0515)|2012_B05 (0.0481)|960_B03 (0.0430)|1279_B07 (0.0335)|2013_A01 (0.0326)|925_F03 (0.0326)|2013_B01 (0.0301)|2018_C01 (0.0236)|1482_A03 (0.0232)|994_C03 (0.0232)|2018_D01 (0.0210)|1279_A07 (0.0185)|1169_A01 (0.0168)|1458_A09 (0.0112)	0.1284	1075_B04 (0.1284)|a total of 5082 cells in this dominant library	GPi(0.3466)| STH(0.3299)| GPe(0.1357)| SN-VTA(0.0597)| GPeR(0.0473)| SN(0.0382)| PuPV(0.0099)| GPeC(0.0086)| CaB(0.0073)| CaT(0.0073)| NAC(0.0056)| PuC(0.0017)| Pu(0.0017)| CaH(0.0004)| PuR(0.0)	Balanced	0	0	0	0	0	0.0131	0.0518	2873	6198	2.16
AIT117_241	NN_3		AIT117_348	BN Astrocyte	cluster							1264	3	['LINC01727', 'KCNJ16', 'AC097518.2']	['LINC01727', 'KCNJ16', 'AL355612.1', 'LGR6', 'AC097518.2', 'WDR49', 'SLC6A11', 'PAMR1', 'SLC24A4', 'FAM189A2']	H18.30.001(0.4415)| H20.30.002(0.2144)| H19.30.004(0.1978)| H23.30.001(0.0934)| H20.30.001(0.053)	Balanced	Balanced	1075_B04 (0.4209)|1169_A01 (0.1804)|1279_B07 (0.0989)|1279_A07 (0.0965)|2058_B03 (0.0285)|988_E05 (0.0285)|1001_B06 (0.0222)|2012_A05 (0.0222)|2012_B05 (0.0174)|2058_C03 (0.0150)	0.4209	1075_B04 (0.4209)|a total of 5082 cells in this dominant library	STH(0.8339)| GPi(0.0451)| PuPV(0.0293)| GPe(0.0269)| SN-VTA(0.0261)| SN(0.0245)| GPeR(0.0095)| GPeC(0.0024)| PuC(0.0016)| NAC(0.0008)| CaT(0.0)| CaH(0.0)| CaB(0.0)| Pu(0.0)| PuR(0.0)	Balanced	0	0	0	0	0	0	0.0631	3230	7704.5	2.39
AIT117_242	NN_4		AIT117_348	BN Astrocyte	cluster							2514	6	['TNC', 'GINS3', 'ID2', 'AQP4', 'EFEMP1', 'AC012405.1']	['TNC', 'GINS3', 'ID2', 'AQP4', 'EFEMP1', 'AC012405.1', 'HPSE2', 'VCAN', 'ADAMTSL3', 'NPL']	H18.30.001(0.3182)| H23.30.001(0.3075)| H20.30.001(0.2474)| H20.30.002(0.1237)| H19.30.004(0.0032)	Balanced	Balanced	858_D03 (0.1249)|853_B07 (0.1221)|960_B03 (0.1201)|2012_A05 (0.1098)|2013_A01 (0.0668)|1036_C03 (0.0636)|853_A07 (0.0628)|2018_C01 (0.0569)|994_C03 (0.0469)|1477_A07 (0.0390)|988_E05 (0.0378)|1042_C06 (0.0219)|2012_B05 (0.0163)|2006_B05 (0.0163)|1482_A03 (0.0151)|2016_A03 (0.0131)	0.1249	858_D03 (0.1249)|a total of 4783 cells in this dominant library	GPi(0.2657)| GPe(0.2498)| GPeR(0.183)| GPeC(0.1221)| NAC(0.0947)| PuPV(0.0489)| STH(0.0099)| Pu(0.006)| CaT(0.0048)| CaB(0.0044)| CaH(0.004)| PuC(0.0036)| PuR(0.0016)| SN-VTA(0.0012)| SN(0.0004)	Balanced	0	0	0	0	0	0.011	0.0677	2830.5	6648.5	2.35
AIT117_5	NN_5		AIT117_348	BN Astrocyte	cluster							1435	2	['IL6R-AS1', 'EMP1']	['IL6R-AS1', 'CHI3L1', 'EMP1', 'CD44', 'DEC1', 'F3', 'TNC', 'AC016831.1', 'WWTR1', 'CLIC4']	H20.30.001(0.8871)| H18.30.001(0.0662)| H23.30.001(0.0314)| H19.30.004(0.0084)| H20.30.002(0.007)	Balanced	Balanced	960_B03 (0.3491)|988_E05 (0.2613)|994_C03 (0.1735)|1482_A03 (0.0948)|853_A07 (0.0404)|858_D03 (0.0139)|853_B07 (0.0105)	0.3491	960_B03 (0.3491)|a total of 3661 cells in this dominant library	GPeR(0.3895)| GPi(0.292)| PuPV(0.262)| GPe(0.023)| STH(0.0125)| GPeC(0.0105)| NAC(0.0049)| SN-VTA(0.0042)| SN(0.0007)| PuC(0.0007)| CaT(0.0)| CaH(0.0)| CaB(0.0)| Pu(0.0)| PuR(0.0)	Balanced	0	0	0	0	0	0.0423	0.0573	2624	7749	2.95
AIT117_243	NN_6		AIT117_348	BN Astrocyte	cluster							870	4	['ADM', 'SLC7A10', 'LINC00906', 'KCNJ16']	['ADM', 'SLC7A10', 'AC104574.2', 'LINC00906', 'AL355612.1', 'KCNJ16', 'AL627316.1', 'CPAMD8', 'SLC6A11', 'LINC00609']	H18.30.001(0.5471)| H23.30.001(0.2333)| H19.30.004(0.0908)| H20.30.002(0.069)| H20.30.001(0.0598)	Balanced	Balanced	858_D03 (0.2241)|1075_B04 (0.1425)|2012_A05 (0.1207)|853_B07 (0.0897)|853_A07 (0.0816)|1477_A07 (0.0483)|1279_B07 (0.0471)|2012_B05 (0.0402)|1279_A07 (0.0345)|2058_B03 (0.0322)|994_C03 (0.0218)|1482_A03 (0.0149)|2016_A03 (0.0126)|960_B03 (0.0115)	0.2241	858_D03 (0.2241)|a total of 4783 cells in this dominant library	GPi(0.3678)| STH(0.277)| GPe(0.1391)| GPeR(0.0931)| GPeC(0.0897)| SN(0.0115)| SN-VTA(0.0115)| PuPV(0.008)| PuC(0.0011)| CaH(0.0011)| CaT(0.0)| CaB(0.0)| Pu(0.0)| NAC(0.0)| PuR(0.0)	Balanced	0	0	0	0	0	0.12	0.0564	5685	19624	3.45
AIT117_244	NN_7		AIT117_348	BN Astrocyte	cluster							2704	4	['STK32A', 'TOGARAM2', 'TNC', 'ZNF98']	['ANGPTL4', 'STK32A', 'TOGARAM2', 'TNC', 'LINC01088', 'ZNF98', 'SLC6A11', 'HPSE2', 'AC079352.1', 'FAM189A2']	H20.30.001(0.3561)| H23.30.001(0.3236)| H18.30.001(0.2104)| H20.30.002(0.0962)| H19.30.004(0.0137)	Balanced	Balanced	994_C03 (0.1568)|858_D03 (0.1442)|960_B03 (0.1413)|1477_A07 (0.0839)|2012_B05 (0.0729)|2012_A05 (0.0725)|2013_B01 (0.0684)|1482_A03 (0.0440)|2018_C01 (0.0340)|2013_A01 (0.0296)|853_B07 (0.0255)|853_A07 (0.0229)|2058_B03 (0.0178)|1075_B04 (0.0170)|2016_A03 (0.0166)|988_E05 (0.0118)	0.1568	994_C03 (0.1568)|a total of 4714 cells in this dominant library	GPi(0.5925)| GPeR(0.1642)| GPe(0.1376)| STH(0.0533)| GPeC(0.0255)| PuPV(0.0159)| SN-VTA(0.0041)| NAC(0.0033)| PuC(0.0026)| CaT(0.0007)| SN(0.0004)| CaB(0.0)| CaH(0.0)| Pu(0.0)| PuR(0.0)	Balanced	0	0	0	0	0	0.0256	0.0438	3233	8323	2.57
AIT117_245	NN_8		AIT117_348	BN Astrocyte	cluster							174	2	['AL356488.2', 'SLC6A11']	['AL356488.2', 'AC036214.1', 'SLC22A4', 'CMYA5', 'ALDH1A1', 'SLC6A11', 'OBI1-AS1', 'HPSE2', 'AC114971.1', 'TCF7L1']	H20.30.001(0.8506)| H18.30.001(0.092)| H23.30.001(0.0345)| H19.30.004(0.0115)| H20.30.002(0.0115)	Balanced	Balanced	994_C03 (0.3966)|960_B03 (0.2701)|1482_A03 (0.0977)|988_E05 (0.0805)|858_D03 (0.0345)|1075_B04 (0.0287)|853_A07 (0.0172)|1279_B07 (0.0115)|1477_A07 (0.0115)|2012_B05 (0.0115)	0.3966	994_C03 (0.3966)|a total of 4714 cells in this dominant library	GPi(0.5632)| GPeR(0.2874)| PuPV(0.0805)| STH(0.046)| NAC(0.0115)| GPe(0.0057)| GPeC(0.0057)| CaH(0.0)| CaB(0.0)| CaT(0.0)| Pu(0.0)| PuC(0.0)| PuR(0.0)| SN(0.0)| SN-VTA(0.0)	Balanced	0	0	0	0	0	0.0704	0.038	2601.5	7096.5	2.73
AIT117_246	NN_9		AIT117_348	BN Astrocyte	cluster							1459	5	['LGR6', 'SYTL4', 'EDNRB', 'SLC6A11', 'HPSE2']	['LGR6', 'SYTL4', 'EDNRB', 'TNC', 'SLC6A11', 'HPSE2', 'EFEMP1', 'NPL', 'ABCA1', 'MCC']	H20.30.001(0.4373)| H18.30.001(0.3482)| H23.30.001(0.1295)| H20.30.002(0.0788)| H19.30.004(0.0062)	Balanced	Balanced	960_B03 (0.2426)|994_C03 (0.1549)|858_D03 (0.1330)|853_A07 (0.1124)|853_B07 (0.0966)|1036_C03 (0.0555)|2013_A01 (0.0452)|2006_B05 (0.0254)|2012_A05 (0.0206)|988_E05 (0.0164)|2012_B05 (0.0164)|1042_C06 (0.0158)|2018_C01 (0.0103)	0.2426	960_B03 (0.2426)|a total of 3661 cells in this dominant library	GPeR(0.355)| GPi(0.329)| GPe(0.1014)| GPeC(0.0966)| NAC(0.0816)| PuPV(0.0185)| STH(0.0151)| SN-VTA(0.0014)| PuC(0.0007)| CaB(0.0007)| CaT(0.0)| CaH(0.0)| Pu(0.0)| SN(0.0)| PuR(0.0)	Balanced	0	0	0	0	0	0.02	0.0765	3168	8548	2.7
AIT117_247	NN_10		AIT117_349	Oligo RBFOX1	cluster							9708	2	['MBOAT1', 'ANLN']	['MBOAT1', 'LINC01445', 'ENPP6', 'COL18A1', 'SLC5A11', 'ANLN', 'KANK4', 'TF', 'LINC00609', 'SYNJ2']	H23.30.001(0.5186)| H18.30.001(0.1538)| H20.30.002(0.145)| H20.30.001(0.1015)| H19.30.004(0.0811)	Balanced	Balanced	1075_B04 (0.0661)|1169_A01 (0.0572)|2016_A03 (0.0488)|1959_C02 (0.0440)|2058_B03 (0.0393)|1955_C06 (0.0384)|994_C03 (0.0373)|858_D03 (0.0366)|2012_A05 (0.0338)|2012_B05 (0.0305)|1279_B07 (0.0305)|2013_B01 (0.0280)|1279_A07 (0.0271)|2012_C05 (0.0264)|1955_B06 (0.0262)|1959_B02 (0.0260)|822_B01 (0.0239)|1468_A09 (0.0235)|2013_A01 (0.0232)|2018_C01 (0.0221)|1482_A03 (0.0219)|2013_C01 (0.0213)|2006_B05 (0.0205)|1477_A07 (0.0199)|853_B07 (0.0189)|2018_E01 (0.0183)|1001_B06 (0.0156)|2016_C03 (0.0149)|960_B03 (0.0134)|2018_B01 (0.0126)|1458_A09 (0.0118)|2018_D01 (0.0112)|2018_A01 (0.0109)|1959_A02 (0.0108)|988_E05 (0.0106)	0.0661	1075_B04 (0.0661)|a total of 5082 cells in this dominant library	STH(0.2556)| GPi(0.2342)| GPe(0.0996)| Pu(0.0824)| PuPV(0.0647)| CaH(0.0539)| CaT(0.0494)| NAC(0.0306)| CaB(0.0263)| PuC(0.0247)| GPeR(0.0222)| GPeC(0.0189)| SN-VTA(0.0159)| PuR(0.0117)| SN(0.0099)	Balanced	0	0	0	0	0	0.02	0.0343	3326	9763	2.94
AIT117_248	NN_11		AIT117_349	Oligo RBFOX1	cluster							2834	2	['AC110809.1', 'LGALS1']	['AC110809.1', 'AC007106.2', 'AC008945.2', 'MBOAT1', 'LINC02343', 'LGALS1', 'PRTG', 'ADAMTS12', 'ACSBG1', 'SYNJ2']	H23.30.001(0.5258)| H20.30.001(0.1433)| H18.30.001(0.1249)| H20.30.002(0.1171)| H19.30.004(0.0889)	Balanced	Balanced	2012_B05 (0.1059)|2012_A05 (0.1034)|2058_B03 (0.0865)|2016_A03 (0.0660)|858_D03 (0.0455)|1169_A01 (0.0438)|994_C03 (0.0395)|1477_A07 (0.0395)|853_B07 (0.0360)|1482_A03 (0.0353)|1279_B07 (0.0332)|1233_A02 (0.0289)|1279_A07 (0.0279)|1468_A09 (0.0279)|2018_C01 (0.0240)|960_B03 (0.0222)|2013_B01 (0.0205)|2013_A01 (0.0201)|2018_D01 (0.0162)|1075_B04 (0.0127)|2006_B05 (0.0116)|2013_C01 (0.0106)|925_F03 (0.0106)	0.1059	2012_B05 (0.1059)|a total of 6229 cells in this dominant library	GPi(0.3684)| STH(0.2414)| GPe(0.1591)| SN(0.0402)| GPeC(0.036)| GPeR(0.0321)| PuPV(0.0293)| CaT(0.0201)| CaH(0.0169)| CaB(0.0152)| NAC(0.0152)| SN-VTA(0.0099)| Pu(0.0095)| PuC(0.006)| PuR(0.0007)	Balanced	0	0	0	0	0	0.04	0.0219	4244	14414	3.4
AIT117_249	NN_12		AIT117_349	Oligo RBFOX1	cluster							602	4	['AC008945.2', 'LRRC63', 'SLC5A11', 'RNF220']	['AC008945.2', 'LINC02343', 'LRRC63', 'SLC5A11', 'CDK18', 'RNF220', 'PLP1', 'PLEKHG1', 'POLR2F', 'PTGDS']	H23.30.001(0.6445)| H20.30.001(0.1312)| H20.30.002(0.1013)| H19.30.004(0.0897)| H18.30.001(0.0332)	Balanced	Balanced	2016_A03 (0.4103)|994_C03 (0.0648)|2012_A05 (0.0415)|1477_A07 (0.0415)|1468_A09 (0.0365)|2058_B03 (0.0349)|1279_B07 (0.0349)|1169_A01 (0.0332)|2013_B01 (0.0332)|2012_B05 (0.0299)|960_B03 (0.0199)|1279_A07 (0.0183)|1075_B04 (0.0166)|1482_A03 (0.0166)|2006_B05 (0.0166)|2013_A01 (0.0150)|2018_D01 (0.0133)|858_D03 (0.0133)|1001_B06 (0.0116)|2012_C05 (0.0116)	0.4103	2016_A03 (0.4103)|a total of 8401 cells in this dominant library	GPi(0.6229)| STH(0.1777)| GPe(0.0814)| PuPV(0.0216)| GPeR(0.0199)| SN-VTA(0.0166)| CaT(0.015)| NAC(0.0133)| CaH(0.0083)| PuC(0.0066)| CaB(0.0066)| Pu(0.005)| SN(0.0033)| PuR(0.0017)| GPeC(0.0)	Balanced	0	0	0	0	0	0.04	0.0429	3518	10690	3.04
AIT117_250	NN_13		AIT117_349	Oligo RBFOX1	cluster							585	4	['MBOAT1', 'PPDPF', 'AL122014.1', 'CRYAB']	['S100A1', 'MBOAT1', 'PPDPF', 'LGALS1', 'AL122014.1', 'CRYAB', 'TSIX', 'S100B', 'CDK18', 'XIST']	H18.30.001(0.6393)| H23.30.001(0.135)| H20.30.002(0.1026)| H20.30.001(0.0838)| H19.30.004(0.0393)	Balanced	Balanced	858_D03 (0.6222)|1001_B06 (0.0564)|994_C03 (0.0359)|2058_B03 (0.0308)|1001_A06 (0.0308)|2012_A05 (0.0274)|1279_A07 (0.0274)|1477_A07 (0.0222)|2012_B05 (0.0222)|2018_D01 (0.0205)|1169_A01 (0.0205)|2012_C05 (0.0171)	0.6222	858_D03 (0.6222)|a total of 4783 cells in this dominant library	GPi(0.7282)| STH(0.0957)| SN-VTA(0.0872)| GPe(0.0359)| CaT(0.0188)| GPeR(0.0137)| SN(0.0103)| PuPV(0.0051)| GPeC(0.0034)| Pu(0.0017)| CaH(0.0)| CaB(0.0)| NAC(0.0)| PuC(0.0)| PuR(0.0)	Balanced	0	0	0	0	0	0	0.0851	4925	17085	3.47
AIT117_251	NN_14		AIT117_350	Oligo OPALIN	cluster							43614	2	['OPALIN', 'LINC01608']	['OPALIN', 'LINC01608', 'CNDP1', 'MOBP', 'ENPP2', 'CLMN', 'CREB5', 'HHIP', 'KCNH8', 'RNF220']	H23.30.001(0.6632)| H20.30.002(0.1329)| H18.30.001(0.1026)| H20.30.001(0.0544)| H19.30.004(0.0469)	Balanced	Balanced	1959_C02 (0.0476)|2012_A05 (0.0469)|2013_A01 (0.0460)|2012_B05 (0.0443)|1959_B02 (0.0442)|1955_B06 (0.0404)|822_B01 (0.0394)|1955_C06 (0.0385)|2018_C01 (0.0371)|1075_B04 (0.0354)|1959_A02 (0.0352)|1477_A07 (0.0350)|2058_B03 (0.0338)|2006_B05 (0.0319)|2016_A03 (0.0319)|2013_B01 (0.0268)|1482_A03 (0.0242)|2018_A01 (0.0227)|822_A01 (0.0213)|2018_D01 (0.0208)|1468_A09 (0.0201)|2013_C01 (0.0195)|2006_A05 (0.0192)|2016_B03 (0.0177)|847_A04 (0.0164)|2018_E01 (0.0160)|2018_B01 (0.0157)|2012_C05 (0.0140)|1279_A07 (0.0135)|1279_B07 (0.0133)|2016_C03 (0.0130)|1169_A01 (0.0120)	0.0476	1959_C02 (0.0476)|a total of 8079 cells in this dominant library	GPi(0.1923)| GPe(0.1619)| STH(0.1335)| CaH(0.1011)| Pu(0.0861)| NAC(0.0797)| PuPV(0.0789)| PuC(0.0489)| CaB(0.0396)| CaT(0.036)| PuR(0.0277)| GPeR(0.0047)| SN-VTA(0.0046)| SN(0.0027)| GPeC(0.0021)	Balanced	0	0	0	0	0	0	0.0364	2452.5	6240	2.54
AIT117_252	NN_15		AIT117_350	Oligo OPALIN	cluster							6376	2	['LINC01608', 'SLC5A11']	['LINC01608', 'SLC5A11', 'CERCAM', 'SCD', 'CLMN', 'RNF220', 'ARHGAP23', 'DOCK5', 'PLP1', 'POLR2F']	H23.30.001(0.5431)| H20.30.001(0.1683)| H19.30.004(0.141)| H20.30.002(0.074)| H18.30.001(0.0736)	Balanced	Balanced	2016_A03 (0.1833)|994_C03 (0.0806)|2013_A01 (0.0634)|1279_A07 (0.0536)|1279_B07 (0.0521)|1482_A03 (0.0518)|2006_B05 (0.0492)|1075_B04 (0.0489)|2013_B01 (0.0397)|1468_A09 (0.0353)|2012_A05 (0.0351)|2012_B05 (0.0290)|2018_C01 (0.0278)|1001_B06 (0.0227)|1477_A07 (0.0215)|822_B01 (0.0179)|1042_C06 (0.0163)|2018_D01 (0.0149)|2058_B03 (0.0136)|2016_C03 (0.0111)|2013_C01 (0.0105)|1955_C06 (0.0102)	0.1833	2016_A03 (0.1833)|a total of 8401 cells in this dominant library	GPi(0.4216)| STH(0.2113)| GPe(0.1755)| PuPV(0.0356)| NAC(0.0276)| SN-VTA(0.0245)| CaT(0.0237)| PuC(0.0218)| Pu(0.0146)| CaB(0.0141)| CaH(0.0124)| GPeR(0.0094)| PuR(0.0038)| SN(0.0035)| GPeC(0.0008)	Balanced	0	0	0	0	0	0.0128	0.0773	2089	4779	2.29
AIT117_253	NN_16		AIT117_350	Oligo OPALIN	cluster							712	5	['OPALIN', 'TMEM123', 'LINC01170', 'HHIP', 'PLP1']	['OPALIN', 'LINC01608', 'TMEM123', 'LINC01170', 'HHIP', 'PLP1', 'DOCK5', 'KCNK10', 'KANK1', 'PTN']	H23.30.001(0.5295)| H20.30.002(0.1938)| H18.30.001(0.1461)| H20.30.001(0.0983)| H19.30.004(0.0323)	Balanced	Balanced	822_B01 (0.0871)|1959_A02 (0.0688)|847_A04 (0.0660)|1959_B02 (0.0576)|1959_C02 (0.0562)|1482_A03 (0.0492)|822_A01 (0.0407)|1955_B06 (0.0407)|2012_C05 (0.0351)|2013_B01 (0.0337)|2018_C01 (0.0253)|1075_B04 (0.0225)|2016_A03 (0.0211)|2058_B03 (0.0197)|2012_B05 (0.0183)|1036_B03 (0.0183)|2006_A05 (0.0169)|1036_C03 (0.0169)|1468_A09 (0.0154)|2013_C01 (0.0154)|2016_C03 (0.0140)|2018_E01 (0.0140)|2006_B05 (0.0140)|2018_B01 (0.0140)|1042_C06 (0.0140)|1091_A05 (0.0140)|2018_A01 (0.0126)|1279_A07 (0.0126)|847_B04 (0.0112)|1036_A03 (0.0112)|1955_C06 (0.0112)|847_C04 (0.0112)	0.0871	822_B01 (0.0871)|a total of 6920 cells in this dominant library	CaH(0.1657)| NAC(0.1657)| GPi(0.1447)| PuPV(0.1278)| STH(0.0857)| Pu(0.0674)| CaT(0.0576)| GPe(0.0562)| PuR(0.052)| CaB(0.0351)| PuC(0.0281)| SN(0.0098)| SN-VTA(0.0028)| GPeC(0.0014)| GPeR(0.0)	Balanced	0	0	0	0	0	0	0.0473	2130.5	5144.5	2.41
AIT117_254	NN_17		AIT117_351	COP	cluster							68	1	['BCAS1']	['GPR17', 'AC008080.4', 'AL512308.1', 'LINC01170', 'SMOC1', 'BCAS1', 'TNS3', 'SIRT2', 'SEMA5B', 'RASGEF1B']	H23.30.001(0.5735)| H18.30.001(0.1471)| H20.30.002(0.1324)| H20.30.001(0.0735)| H19.30.004(0.0735)	Balanced	Balanced	1959_B02 (0.0735)|1959_A02 (0.0735)|822_B01 (0.0588)|1955_B06 (0.0588)|1279_A07 (0.0441)|2058_C03 (0.0441)|2016_C03 (0.0441)|2058_B03 (0.0441)|2012_A05 (0.0294)|2013_C01 (0.0294)|1075_B04 (0.0294)|1001_B06 (0.0294)|988_D05 (0.0294)|1955_C06 (0.0294)|2018_A01 (0.0294)|1110_A07 (0.0294)|2012_C05 (0.0147)|822_A01 (0.0147)|2016_A03 (0.0147)|2016_B03 (0.0147)|1482_A03 (0.0147)|925_F03 (0.0147)|1042_B06 (0.0147)|1036_B03 (0.0147)|2006_B05 (0.0147)|980_C02 (0.0147)|2006_A05 (0.0147)|1959_C02 (0.0147)|1091_A05 (0.0147)|1042_C06 (0.0147)|1468_A09 (0.0147)|1279_B07 (0.0147)|1169_A01 (0.0147)|1477_A07 (0.0147)|2018_B01 (0.0147)|2018_C01 (0.0147)|847_A04 (0.0147)|847_D04 (0.0147)	0.0735	1959_A02 (0.0735)|a total of 6674 cells in this dominant library	NAC(0.1618)| STH(0.1618)| CaH(0.1471)| PuPV(0.1176)| PuC(0.0588)| CaT(0.0588)| GPe(0.0588)| SN(0.0588)| Pu(0.0441)| GPi(0.0441)| CaB(0.0441)| SN-VTA(0.0294)| PuR(0.0147)| GPeR(0.0)| GPeC(0.0)	Balanced	0	0	0	0	0	0	0.0809	3519.5	9466.5	2.69
AIT117_255	NN_18		AIT117_352	OPC	cluster							3544	2	['BX284613.2', 'AC013265.1']	['MROH9', 'BX284613.2', 'COL9A1', 'PDGFRA', 'AC013265.1', 'SLC22A3', 'SEMA3D', 'MEGF11', 'VCAN', 'SEMA3E']	H23.30.001(0.5141)| H19.30.004(0.1414)| H20.30.002(0.1377)| H18.30.001(0.1038)| H20.30.001(0.103)	Balanced	Balanced	2016_A03 (0.0807)|1075_B04 (0.0784)|1468_A09 (0.0660)|2012_B05 (0.0641)|2058_C03 (0.0626)|2012_A05 (0.0609)|2058_B03 (0.0607)|1477_A07 (0.0550)|1482_A03 (0.0474)|2013_B01 (0.0451)|1169_A01 (0.0415)|1279_A07 (0.0406)|2013_A01 (0.0361)|2018_C01 (0.0353)|1279_B07 (0.0347)|2018_D01 (0.0285)|994_C03 (0.0257)|1458_A09 (0.0161)|1001_B06 (0.0161)|2006_B05 (0.0155)|1233_A02 (0.0124)|1001_A06 (0.0110)	0.0807	2016_A03 (0.0807)|a total of 8401 cells in this dominant library	GPi(0.3488)| STH(0.338)| GPe(0.1479)| SN(0.0838)| SN-VTA(0.0271)| PuPV(0.0116)| CaT(0.0087)| NAC(0.0071)| PuC(0.0065)| CaB(0.0065)| GPeR(0.0062)| GPeC(0.004)| Pu(0.002)| CaH(0.0017)| PuR(0.0003)	Balanced	0	0	0	0	0	0.02	0.0713	3161.5	8205.5	2.6
AIT117_256	NN_19		AIT117_353	Microglia	cluster							26809	2	['ADAM28', 'APBB1IP']	['P2RY12', 'TBXAS1', 'ADAM28', 'SYK', 'FYB1', 'APBB1IP', 'DOCK8', 'PTPRC', 'ATP8B4', 'ST6GAL1']	H23.30.001(0.4813)| H18.30.001(0.1996)| H20.30.002(0.1912)| H20.30.001(0.0971)| H19.30.004(0.0309)	Balanced	Balanced	858_D03 (0.0633)|1001_B06 (0.0545)|2012_A05 (0.0502)|2012_C05 (0.0493)|2058_B03 (0.0458)|2012_B05 (0.0322)|2016_A03 (0.0321)|1959_C02 (0.0307)|1075_B04 (0.0275)|853_B07 (0.0270)|1959_B02 (0.0261)|988_C05 (0.0248)|1477_A07 (0.0245)|853_A07 (0.0232)|2013_A01 (0.0227)|994_C03 (0.0205)|2018_C01 (0.0201)|2013_B01 (0.0198)|1959_A02 (0.0193)|925_F03 (0.0160)|2018_A01 (0.0155)|1955_B06 (0.0151)|1036_C03 (0.0151)|822_B01 (0.0145)|2006_B05 (0.0144)|2016_B03 (0.0142)|2018_B01 (0.0141)|1955_C06 (0.0137)|2016_C03 (0.0131)|988_D05 (0.0120)|1036_A03 (0.0114)|1279_B07 (0.0109)|2013_C01 (0.0105)|1279_A07 (0.0104)|960_B03 (0.0104)	0.0633	858_D03 (0.0633)|a total of 4783 cells in this dominant library	GPi(0.2022)| STH(0.1115)| GPe(0.1074)| CaT(0.1021)| NAC(0.0922)| SN-VTA(0.0631)| CaH(0.0615)| PuPV(0.0507)| Pu(0.0444)| PuC(0.0411)| GPeR(0.0336)| CaB(0.0333)| GPeC(0.027)| SN(0.0181)| PuR(0.0117)	Balanced	0	0	0	0	0	0	0.0705	2155	4545	2.11
AIT117_257	NN_20		AIT117_353	Microglia	cluster							2122	4	['SLC26A3', 'STEAP1B', 'ADAM28', 'TBXAS1']	['SLC26A3', 'STEAP1B', 'C3', 'CD74', 'ADAM28', 'TBXAS1', 'LPAR6', 'FYB1', 'APBB1IP', 'DOCK8']	H23.30.001(0.7003)| H20.30.001(0.2455)| H20.30.002(0.032)| H18.30.001(0.0207)| H19.30.004(0.0014)	Balanced	Balanced	2058_C03 (0.5203)|1001_A06 (0.2257)|2058_B03 (0.1107)|1001_B06 (0.0203)|2012_C05 (0.0170)|858_D03 (0.0132)|2016_A03 (0.0132)|2012_A05 (0.0108)	0.5203	2058_C03 (0.5203)|a total of 4967 cells in this dominant library	SN(0.5231)| SN-VTA(0.246)| STH(0.1145)| GPi(0.049)| CaT(0.0207)| GPe(0.0156)| PuPV(0.0099)| GPeR(0.0061)| NAC(0.0047)| PuC(0.0042)| CaB(0.0024)| CaH(0.0024)| GPeC(0.0005)| Pu(0.0005)| PuR(0.0005)	Balanced	0	0	0	0	0	0	0.0912	2699	6115.5	2.27
AIT117_258	NN_21		AIT117_354	Endo	cluster							733	3	['PODXL', 'ADGRL4', 'ABCG2']	['CD34', 'VWF', 'PODXL', 'ADGRL4', 'ABCG2', 'MECOM', 'ERG', 'FLT1', 'SLC7A5', 'GPR85']	H23.30.001(0.8172)| H20.30.001(0.0655)| H20.30.002(0.0464)| H19.30.004(0.0437)| H18.30.001(0.0273)	Balanced	Balanced	2013_B01 (0.1269)|2016_A03 (0.0914)|2013_A01 (0.0778)|2058_B03 (0.0696)|2013_C01 (0.0600)|2012_B05 (0.0450)|2012_A05 (0.0409)|2016_B03 (0.0368)|2018_A01 (0.0355)|2018_C01 (0.0300)|2006_A05 (0.0300)|1959_C02 (0.0286)|2058_C03 (0.0259)|1482_A03 (0.0218)|1959_B02 (0.0205)|1279_B07 (0.0205)|2016_C03 (0.0191)|2018_B01 (0.0191)|1477_A07 (0.0164)|1959_A02 (0.0150)|2018_E01 (0.0136)|2006_B05 (0.0136)|1468_A09 (0.0123)|994_C03 (0.0123)|1458_A09 (0.0109)|1279_A07 (0.0109)	0.1269	2013_B01 (0.1269)|a total of 4881 cells in this dominant library	GPi(0.3192)| GPe(0.1623)| STH(0.1351)| CaB(0.0969)| PuC(0.075)| PuPV(0.0464)| Pu(0.0341)| CaH(0.0314)| SN(0.0273)| CaT(0.0259)| NAC(0.0232)| SN-VTA(0.0095)| GPeR(0.0055)| GPeC(0.0041)| PuR(0.0041)	Balanced	0	0	0	0	0	0.0133	0.685	2794	6169	2.21
AIT117_259	NN_22		AIT117_354	Endo	cluster							689	2	['ADGRL4', 'ABCG2']	['VWF', 'ADGRL4', 'PODXL', 'ABCG2', 'MECOM', 'ERG', 'FLT1', 'ADGRF5', 'ATP10A', 'ANO2']	H23.30.001(0.6125)| H20.30.001(0.1626)| H18.30.001(0.0798)| H20.30.002(0.0769)| H19.30.004(0.0682)	Balanced	Balanced	2012_A05 (0.0726)|988_E05 (0.0726)|2013_A01 (0.0595)|2016_A03 (0.0522)|2012_B05 (0.0464)|2058_B03 (0.0435)|2018_E01 (0.0392)|2013_C01 (0.0334)|1279_B07 (0.0305)|2016_B03 (0.0305)|2006_A05 (0.0276)|2013_B01 (0.0276)|2018_C01 (0.0247)|960_B03 (0.0218)|2012_C05 (0.0218)|1959_C02 (0.0218)|2018_D01 (0.0203)|1279_A07 (0.0203)|994_C03 (0.0189)|1468_A09 (0.0174)|853_B07 (0.0160)|988_D05 (0.0145)|1001_B06 (0.0145)|1959_B02 (0.0145)|2016_C03 (0.0145)|1036_A03 (0.0131)|2058_C03 (0.0131)|1482_A03 (0.0131)|1959_A02 (0.0116)|2018_B01 (0.0116)|2006_B05 (0.0102)|1477_A07 (0.0102)|930_E05 (0.0102)|1169_A01 (0.0102)|858_D03 (0.0102)	0.0726	988_E05 (0.0726)|a total of 10190 cells in this dominant library	GPi(0.1988)| GPe(0.1669)| STH(0.1321)| PuPV(0.1045)| CaT(0.0784)| CaB(0.074)| PuC(0.0522)| NAC(0.0493)| CaH(0.0348)| Pu(0.0247)| GPeR(0.0247)| SN(0.0189)| GPeC(0.016)| SN-VTA(0.0145)| PuR(0.0102)	Balanced	0	0	0	0	0	0	0.1155	2317	4970	2.15
AIT117_260	NN_23		AIT117_354	Endo	cluster							125	1	['MECOM']	['LINC00840', 'FBLN5', 'VEGFC', 'SMAD6', 'ELN', 'MECOM', 'SOX13', 'EPAS1', 'ROR1', 'EFNB2']	H23.30.001(0.752)| H20.30.002(0.096)| H20.30.001(0.088)| H19.30.004(0.048)| H18.30.001(0.016)	Balanced	Balanced	2013_A01 (0.1680)|2013_C01 (0.1120)|2058_B03 (0.1040)|2058_C03 (0.0720)|1477_A07 (0.0560)|2018_E01 (0.0560)|2013_B01 (0.0400)|1468_A09 (0.0400)|2012_B05 (0.0400)|2016_A03 (0.0240)|2006_A05 (0.0240)|1959_B02 (0.0240)|1458_A09 (0.0160)|2012_A05 (0.0160)|1001_B06 (0.0160)|1959_A02 (0.0160)|994_C03 (0.0160)|1042_C06 (0.0160)|2016_C03 (0.0160)|2016_B03 (0.0160)	0.168	2013_A01 (0.168)|a total of 5825 cells in this dominant library	GPe(0.192)| GPi(0.192)| STH(0.176)| CaB(0.136)| CaT(0.072)| SN(0.072)| NAC(0.056)| SN-VTA(0.024)| PuPV(0.024)| CaH(0.024)| PuC(0.024)| Pu(0.008)| GPeC(0.0)| GPeR(0.0)| PuR(0.0)	Balanced	0	0	0	0	0	0	0.1507	1921	4137	2.15
AIT117_261	NN_25		AIT117_354	Endo	cluster							73	5	['MECOM', 'RGMA', 'OBI1-AS1', 'HPSE2', 'PSD2']	['MECOM', 'TNC', 'RGMA', 'OBI1-AS1', 'HPSE2', 'PSD2', 'FAM189A2', 'LINC00299', 'PLPP3', 'ARHGEF26']	H23.30.001(0.6575)| H20.30.001(0.1507)| H18.30.001(0.137)| H20.30.002(0.0411)| H19.30.004(0.0137)	Balanced	Balanced	2058_C03 (0.1918)|988_E05 (0.0822)|2013_A01 (0.0685)|2012_A05 (0.0548)|2016_A03 (0.0548)|2006_A05 (0.0411)|925_F03 (0.0411)|1169_A01 (0.0274)|1959_B02 (0.0274)|994_C03 (0.0274)|988_D05 (0.0274)|2006_B05 (0.0274)|2012_B05 (0.0274)|2058_B03 (0.0274)|853_A07 (0.0274)|2018_E01 (0.0274)|1482_A03 (0.0137)|1955_B06 (0.0137)|1110_A07 (0.0137)|1036_C03 (0.0137)|1110_B07 (0.0137)|1959_C02 (0.0137)|1001_A06 (0.0137)|2018_C01 (0.0137)|1468_A09 (0.0137)|853_B07 (0.0137)|2016_C03 (0.0137)|2012_C05 (0.0137)|930_D05 (0.0137)|2013_C01 (0.0137)|2013_B01 (0.0137)|2018_B01 (0.0137)	0.1918	2058_C03 (0.1918)|a total of 4967 cells in this dominant library	SN(0.2329)| GPe(0.1644)| GPi(0.137)| PuPV(0.1096)| STH(0.0685)| CaT(0.0685)| CaB(0.0548)| CaH(0.0411)| NAC(0.0411)| GPeR(0.0274)| GPeC(0.0137)| PuC(0.0137)| Pu(0.0137)| SN-VTA(0.0137)| PuR(0.0)	Balanced	0	0.39	0	0.5	0.5	0.0244	0.1493	3858	9213	2.39
AIT117_262	NN_26		AIT117_354	Endo	cluster							82	4	['MECOM', 'C3', 'ATP10A', 'ADAM28']	['MECOM', 'C3', 'P2RY12', 'ATP10A', 'LINC02712', 'ADAM28', 'SAMSN1', 'APBB1IP', 'DOCK8', 'RASGEF1C']	H23.30.001(0.6951)| H20.30.001(0.1463)| H18.30.001(0.1341)| H20.30.002(0.0244)| H19.30.004(0.0)	Balanced	Balanced	2016_A03 (0.1220)|2058_B03 (0.1098)|2012_A05 (0.0732)|2058_C03 (0.0732)|853_B07 (0.0732)|960_B03 (0.0366)|2013_A01 (0.0366)|2012_B05 (0.0366)|2018_B01 (0.0366)|2018_C01 (0.0366)|988_E05 (0.0366)|1042_C06 (0.0244)|1959_A02 (0.0244)|2016_C03 (0.0244)|1955_C06 (0.0244)|2006_A05 (0.0244)|2013_B01 (0.0244)|988_D05 (0.0244)|1959_C02 (0.0122)|1482_A03 (0.0122)|1169_A01 (0.0122)|994_C03 (0.0122)|2018_E01 (0.0122)|2018_D01 (0.0122)|853_A07 (0.0122)|858_D03 (0.0122)|891_A06 (0.0122)|930_D05 (0.0122)|930_E05 (0.0122)|2012_C05 (0.0122)|988_C05 (0.0122)	0.122	2016_A03 (0.122)|a total of 8401 cells in this dominant library	GPi(0.2317)| GPe(0.1463)| STH(0.122)| PuPV(0.0976)| SN(0.0732)| GPeC(0.0732)| CaT(0.061)| CaB(0.0488)| GPeR(0.0488)| NAC(0.0488)| Pu(0.0366)| PuC(0.0122)| CaH(0.0)| PuR(0.0)| SN-VTA(0.0)	Balanced	0	0.24	0	0.58	0.58	0.0626	0.1919	3724.5	9173.5	2.46
AIT117_263	NN_27		AIT117_354	Endo	cluster							355	2	['IL1R1', 'VWF']	['IL1R1', 'ADGRG6', 'VWF', 'TRPM6', 'PLA2G4A', 'PGM5', 'ANO2', 'CDH23', 'BNC2', 'ABCB1']	H23.30.001(0.6563)| H20.30.001(0.1099)| H18.30.001(0.093)| H20.30.002(0.0789)| H19.30.004(0.062)	Balanced	Balanced	2013_B01 (0.0620)|2016_A03 (0.0620)|2013_C01 (0.0563)|2006_A05 (0.0507)|2058_B03 (0.0479)|2016_B03 (0.0479)|2012_B05 (0.0451)|988_E05 (0.0423)|2012_A05 (0.0423)|2013_A01 (0.0394)|2018_E01 (0.0366)|1279_A07 (0.0254)|1279_B07 (0.0254)|2018_B01 (0.0225)|2016_C03 (0.0197)|2058_C03 (0.0197)|994_C03 (0.0169)|2012_C05 (0.0141)|2006_B05 (0.0141)|925_F03 (0.0141)|960_B03 (0.0141)|1959_A02 (0.0141)|1477_A07 (0.0141)|2018_D01 (0.0141)|853_B07 (0.0141)|2018_A01 (0.0113)|858_D03 (0.0113)|1955_B06 (0.0113)|1482_A03 (0.0113)|1468_A09 (0.0113)|1959_C02 (0.0113)|1458_A09 (0.0113)	0.062	2013_B01 (0.062)|a total of 4881 cells in this dominant library	GPi(0.2366)| STH(0.1324)| CaB(0.1239)| GPe(0.1014)| PuPV(0.093)| CaT(0.0704)| PuC(0.0676)| NAC(0.0479)| SN(0.0338)| CaH(0.0282)| GPeR(0.0197)| GPeC(0.0141)| Pu(0.0113)| PuR(0.0113)| SN-VTA(0.0085)	Balanced	0	0	0	0	0	0.0133	0.1227	2737	6578	2.4
AIT117_264	NN_30		AIT117_354	Endo	cluster							611	3	['CARMN', 'RGS5', 'FLT1']	['NOTCH3', 'CARMN', 'SLC19A1', 'GJC1', 'RGS5', 'FLT1', 'ATP10A', 'PDGFRB', 'SLC38A11', 'TRPC3']	H23.30.001(0.9002)| H20.30.001(0.0426)| H18.30.001(0.0295)| H20.30.002(0.0213)| H19.30.004(0.0065)	Cautious	Balanced	2016_A03 (0.1800)|2016_B03 (0.0769)|2006_A05 (0.0671)|2058_C03 (0.0556)|2012_A05 (0.0540)|2013_C01 (0.0540)|2013_B01 (0.0507)|2013_A01 (0.0491)|2058_B03 (0.0475)|2012_B05 (0.0426)|1959_C02 (0.0426)|1959_A02 (0.0409)|2006_B05 (0.0262)|1959_B02 (0.0196)|2018_A01 (0.0164)|2018_B01 (0.0147)|2016_C03 (0.0147)|2018_C01 (0.0115)|2018_E01 (0.0115)|988_E05 (0.0115)	0.18	2016_A03 (0.18)|a total of 8401 cells in this dominant library	GPi(0.2913)| GPe(0.1408)| CaB(0.1342)| PuC(0.0949)| STH(0.0606)| SN(0.0589)| Pu(0.0491)| NAC(0.0475)| PuPV(0.0426)| CaH(0.0426)| CaT(0.0229)| GPeR(0.0065)| PuR(0.0049)| GPeC(0.0016)| SN-VTA(0.0016)	Balanced	0	0	0	0	0	0.0638	1.023	6002	21690	3.61
AIT117_265	NN_31		AIT117_355	SMC	cluster							213	1	['MYH11']	['TAGLN', 'ADAMTS1', 'ACTA2', 'TPM2', 'MYOCD', 'MYH11', 'MCAM', 'FLNA', 'MYL9', 'ITGA8']	H23.30.001(0.507)| H18.30.001(0.1784)| H20.30.001(0.1737)| H19.30.004(0.0939)| H20.30.002(0.0469)	Balanced	Balanced	2012_B05 (0.0845)|2013_A01 (0.0751)|1468_A09 (0.0704)|858_D03 (0.0563)|1959_C02 (0.0423)|2018_C01 (0.0376)|2016_B03 (0.0376)|994_C03 (0.0329)|1075_B04 (0.0329)|1477_A07 (0.0329)|2012_A05 (0.0329)|2016_A03 (0.0329)|2013_B01 (0.0329)|2018_D01 (0.0282)|2058_B03 (0.0282)|960_B03 (0.0235)|1001_A06 (0.0188)|853_B07 (0.0188)|925_F03 (0.0188)|1959_B02 (0.0188)|2058_C03 (0.0141)|2018_E01 (0.0141)|1279_A07 (0.0141)|980_C02 (0.0141)|930_D05 (0.0141)|1482_A03 (0.0141)|1042_C06 (0.0141)|988_D05 (0.0141)|988_E05 (0.0141)	0.0845	2012_B05 (0.0845)|a total of 6229 cells in this dominant library	GPi(0.3146)| STH(0.1596)| GPe(0.1455)| PuC(0.0516)| NAC(0.0469)| Pu(0.0423)| CaT(0.0423)| SN(0.0329)| GPeR(0.0329)| CaB(0.0282)| PuPV(0.0282)| SN-VTA(0.0235)| CaH(0.0235)| GPeC(0.0188)| PuR(0.0094)	Balanced	0	0	0	0	0	0	0.4517	1933	4399	2.28
AIT117_266	NN_32		AIT117_356	Pericyte	cluster							1344	2	['SLC19A1', 'RGS5']	['SLC6A12', 'NOTCH3', 'CARMN', 'SLC19A1', 'GJC1', 'RGS5', 'PDGFRB', 'SLC38A11', 'TRPC3', 'SLC30A10']	H23.30.001(0.5253)| H20.30.002(0.154)| H20.30.001(0.1458)| H18.30.001(0.1287)| H19.30.004(0.0461)	Balanced	Balanced	2013_B01 (0.0521)|2006_A05 (0.0484)|2013_A01 (0.0469)|2016_A03 (0.0387)|988_E05 (0.0365)|2018_A01 (0.0320)|2016_B03 (0.0312)|858_D03 (0.0283)|2058_B03 (0.0275)|988_C05 (0.0275)|897_E03 (0.0253)|1959_C02 (0.0246)|2013_C01 (0.0246)|2058_C03 (0.0246)|853_B07 (0.0238)|2012_A05 (0.0231)|2012_B05 (0.0223)|1001_B06 (0.0216)|2018_E01 (0.0208)|988_D05 (0.0201)|1959_B02 (0.0193)|1279_B07 (0.0186)|1279_A07 (0.0171)|2018_B01 (0.0171)|2018_C01 (0.0171)|1075_B04 (0.0156)|930_D05 (0.0156)|994_C03 (0.0156)|930_F05 (0.0149)|2006_B05 (0.0141)|822_B01 (0.0141)|1477_A07 (0.0134)|853_A07 (0.0126)|960_B03 (0.0126)|2012_C05 (0.0119)|822_A01 (0.0119)|2016_C03 (0.0119)|930_E05 (0.0112)|1468_A09 (0.0104)|930_B05 (0.0104)	0.0521	2013_B01 (0.0521)|a total of 4881 cells in this dominant library	GPi(0.1808)| CaB(0.1168)| GPe(0.1012)| STH(0.0967)| PuC(0.09)| CaT(0.0841)| PuPV(0.0811)| NAC(0.0484)| CaH(0.0365)| SN(0.0298)| SN-VTA(0.029)| Pu(0.0283)| PuR(0.0283)| GPeR(0.0253)| GPeC(0.0238)	Balanced	0	0	0	0	0	0	0.4438	2446	5450.5	2.23
AIT117_267	NN_33		AIT117_357	VLMC	cluster							2307	1	['COL15A1']	['VIT', 'COL3A1', 'C7', 'COL15A1', 'CYP1B1', 'COL6A3', 'COL1A2', 'TBX18', 'DCN', 'ABCA8']	H23.30.001(0.4629)| H18.30.001(0.2063)| H20.30.001(0.1786)| H20.30.002(0.1127)| H19.30.004(0.0394)	Balanced	Balanced	2012_A05 (0.0503)|988_E05 (0.0459)|988_D05 (0.0455)|2013_A01 (0.0425)|2012_B05 (0.0412)|960_B03 (0.0338)|853_B07 (0.0308)|2006_A05 (0.0277)|2016_B03 (0.0277)|858_D03 (0.0277)|2006_B05 (0.0256)|891_A06 (0.0247)|2016_A03 (0.0247)|1959_C02 (0.0230)|2058_B03 (0.0217)|2013_B01 (0.0212)|1959_B02 (0.0186)|1279_A07 (0.0178)|994_C03 (0.0178)|2018_A01 (0.0160)|925_F03 (0.0156)|2018_B01 (0.0156)|1482_A03 (0.0147)|1955_B06 (0.0147)|1001_B06 (0.0147)|2018_C01 (0.0147)|930_B05 (0.0143)|2012_C05 (0.0143)|2016_C03 (0.0143)|853_A07 (0.0143)|930_C05 (0.0130)|897_E03 (0.0130)|2013_C01 (0.0121)|988_C05 (0.0117)|2018_E01 (0.0113)|1468_A09 (0.0108)|1075_B04 (0.0108)|1279_B07 (0.0108)|1169_A01 (0.0104)|930_D05 (0.0104)|930_F05 (0.0104)	0.0503	2012_A05 (0.0503)|a total of 7367 cells in this dominant library	GPi(0.1621)| GPe(0.1331)| STH(0.0884)| CaT(0.0871)| CaB(0.0832)| PuPV(0.0828)| PuC(0.0728)| CaH(0.059)| NAC(0.0511)| GPeR(0.0481)| Pu(0.0321)| GPeC(0.0308)| PuR(0.0243)| SN(0.0234)| SN-VTA(0.0217)	Balanced	0	0	0	0	0	0.0122	0.1638	2589	5571	2.15
AIT117_268	NN_37		AIT117_352	OPC	cluster							322	4	['AC004852.2', 'ENPP2', 'VCAN', 'RNF220']	['AC004852.2', 'BX284613.2', 'LINC01608', 'ENPP2', 'VCAN', 'RNF220', 'TMEM144', 'PLP1', 'ST18', 'CA10']	H23.30.001(0.7764)| H20.30.002(0.0776)| H20.30.001(0.0621)| H18.30.001(0.0559)| H19.30.004(0.028)	Balanced	Balanced	2018_D01 (0.1087)|2006_A05 (0.0683)|2016_B03 (0.0528)|1955_C06 (0.0497)|1959_A02 (0.0497)|2016_C03 (0.0497)|1959_B02 (0.0404)|1169_A01 (0.0404)|1959_C02 (0.0404)|1955_B06 (0.0404)|2018_E01 (0.0404)|2006_B05 (0.0373)|2016_A03 (0.0311)|1233_A02 (0.0311)|2018_A01 (0.0280)|847_A04 (0.0280)|2012_C05 (0.0217)|2013_C01 (0.0217)|1468_A09 (0.0186)|2018_C01 (0.0186)|2058_B03 (0.0186)|2018_B01 (0.0155)|2058_C03 (0.0155)|2012_B05 (0.0155)|1075_B04 (0.0124)|822_B01 (0.0124)	0.1087	2018_D01 (0.1087)|a total of 2261 cells in this dominant library	GPi(0.1832)| CaH(0.1087)| STH(0.1025)| Pu(0.0901)| CaB(0.0901)| PuC(0.0807)| PuPV(0.0807)| NAC(0.0745)| CaT(0.0652)| GPe(0.059)| SN(0.0497)| SN-VTA(0.0093)| PuR(0.0062)| GPeR(0.0)| GPeC(0.0)	Balanced	0	0	0	0	0	0.0976	0.0488	3347	8093	2.42
AIT117_269	NN_38		AIT117_352	OPC	cluster							324	4	['BX284613.2', 'PDGFRA', 'ETNPPL', 'OBI1-AS1']	['BX284613.2', 'AC004852.2', 'PDGFRA', 'ETNPPL', 'MEGF11', 'OBI1-AS1', 'HPSE2', 'EFEMP1', 'AC012405.1', 'FAM189A2']	H23.30.001(0.5926)| H18.30.001(0.1975)| H20.30.002(0.1049)| H20.30.001(0.071)| H19.30.004(0.034)	Balanced	Balanced	2058_B03 (0.0957)|2058_C03 (0.0864)|925_F03 (0.0617)|2012_C05 (0.0586)|2016_A03 (0.0432)|891_A06 (0.0401)|2012_A05 (0.0370)|1955_B06 (0.0340)|1075_B04 (0.0309)|2013_A01 (0.0278)|988_C05 (0.0278)|988_E05 (0.0247)|1001_B06 (0.0247)|2013_B01 (0.0247)|2006_A05 (0.0247)|1959_A02 (0.0247)|2018_E01 (0.0216)|2016_C03 (0.0185)|822_B01 (0.0185)|2013_C01 (0.0185)|1959_C02 (0.0185)|853_B07 (0.0154)|1169_A01 (0.0154)|1279_B07 (0.0154)|1091_A05 (0.0154)|2018_B01 (0.0123)|1468_A09 (0.0123)	0.0957	2058_B03 (0.0957)|a total of 5698 cells in this dominant library	STH(0.1852)| SN(0.1512)| CaT(0.1235)| GPi(0.0895)| CaB(0.0864)| GPe(0.0741)| PuPV(0.0741)| NAC(0.0679)| CaH(0.0463)| SN-VTA(0.0309)| Pu(0.0247)| PuC(0.0154)| GPeC(0.0154)| GPeR(0.0093)| PuR(0.0062)	Balanced	0	0	0	0	0	0.0896	0.0521	4178	10625	2.54
AIT117_270	NN_39		AIT117_352	OPC	cluster							215	4	['AC004852.2', 'PDGFRA', 'APBB1IP', 'DOCK8']	['BX284613.2', 'AC004852.2', 'PDGFRA', 'ADAM28', 'APBB1IP', 'DOCK8', 'PTPRC', 'VCAN', 'ATP8B4', 'CA10']	H23.30.001(0.5581)| H18.30.001(0.2279)| H20.30.002(0.0977)| H20.30.001(0.0837)| H19.30.004(0.0326)	Balanced	Balanced	925_F03 (0.1023)|2016_A03 (0.0977)|2058_C03 (0.0698)|2012_C05 (0.0558)|1001_B06 (0.0512)|980_C02 (0.0419)|2016_C03 (0.0372)|2058_B03 (0.0372)|2018_C01 (0.0326)|1279_A07 (0.0326)|988_D05 (0.0279)|2012_B05 (0.0279)|1075_B04 (0.0279)|1959_A02 (0.0233)|2013_B01 (0.0233)|1955_C06 (0.0233)|891_A06 (0.0186)|2012_A05 (0.0186)|853_B07 (0.0140)|1233_A02 (0.0140)|822_B01 (0.0140)|2013_C01 (0.0140)|2018_E01 (0.0140)|1036_A03 (0.0140)|2006_B05 (0.0140)|858_D03 (0.0140)	0.1023	925_F03 (0.1023)|a total of 3479 cells in this dominant library	SN(0.186)| GPi(0.1674)| CaT(0.1442)| STH(0.1023)| GPe(0.0698)| PuPV(0.0651)| SN-VTA(0.0558)| NAC(0.0512)| CaB(0.0512)| Pu(0.0326)| CaH(0.0233)| PuC(0.0233)| GPeC(0.014)| GPeR(0.0093)| PuR(0.0047)	Balanced	0	0.58	0	0	0	0.0909	0.0804	4043	10356	2.56
AIT117_271	NN_40		AIT117_358	T cells	cluster							380	2	['LINC01934', 'CD96']	['GPR174', 'LCK', 'CD2', 'LINC01934', 'CD96', 'GRAP2', 'SKAP1', 'ITK', 'TC2N', 'SLFN12L']	H23.30.001(0.4553)| H20.30.001(0.2053)| H20.30.002(0.1368)| H18.30.001(0.1211)| H19.30.004(0.0816)	Balanced	Balanced	1001_A06 (0.0684)|2058_C03 (0.0500)|1279_A07 (0.0474)|960_B03 (0.0474)|2012_C05 (0.0447)|2012_A05 (0.0447)|1001_B06 (0.0421)|2058_B03 (0.0395)|1075_B04 (0.0368)|2016_A03 (0.0368)|2013_C01 (0.0316)|2018_C01 (0.0263)|988_C05 (0.0263)|2013_B01 (0.0237)|994_C03 (0.0237)|1279_B07 (0.0237)|2012_B05 (0.0211)|2013_A01 (0.0211)|2018_D01 (0.0184)|988_E05 (0.0184)|858_D03 (0.0184)|822_B01 (0.0184)|2016_B03 (0.0158)|2018_A01 (0.0158)|1477_A07 (0.0132)|930_D05 (0.0132)|853_A07 (0.0132)|853_B07 (0.0132)|988_D05 (0.0132)|925_F03 (0.0105)|2018_B01 (0.0105)|1468_A09 (0.0105)|2016_C03 (0.0105)|1959_B02 (0.0105)|1091_A05 (0.0105)|1042_C06 (0.0105)|1959_A02 (0.0105)|1482_A03 (0.0105)	0.0684	1001_A06 (0.0684)|a total of 3218 cells in this dominant library	STH(0.1711)| GPi(0.1658)| SN-VTA(0.1105)| CaT(0.1)| GPe(0.0974)| GPeR(0.0605)| PuPV(0.0605)| SN(0.0605)| NAC(0.0553)| PuC(0.0474)| CaB(0.0421)| GPeC(0.0132)| CaH(0.0132)| Pu(0.0026)| PuR(0.0)	Balanced	0	0	0	0	0	0	0.5272	1831	3814.5	2.08
AIT117_272	NN_41		AIT117_358	T cells	cluster							85	3	['CD3D', 'IL32', 'LINC01871']	['CD3D', 'IL32', 'TRBC2', 'LINC01871', 'CD52', 'TRGC2', 'GZMA', 'CST7', 'NKG7', 'PRF1']	H18.30.001(0.6235)| H19.30.004(0.1647)| H23.30.001(0.1176)| H20.30.001(0.0471)| H20.30.002(0.0471)	Balanced	Balanced	858_D03 (0.2353)|1075_B04 (0.1529)|1279_A07 (0.1294)|925_F03 (0.1176)|988_D05 (0.0353)|2012_C05 (0.0235)|1482_A03 (0.0235)|853_B07 (0.0235)|853_A07 (0.0235)|2018_B01 (0.0235)|1279_B07 (0.0235)|2012_B05 (0.0118)|1001_B06 (0.0118)|2006_A05 (0.0118)|1959_C02 (0.0118)|960_B03 (0.0118)|1468_A09 (0.0118)|1091_A05 (0.0118)|930_F05 (0.0118)|2013_C01 (0.0118)|930_B05 (0.0118)|1477_A07 (0.0118)|891_A06 (0.0118)|847_C04 (0.0118)|2018_D01 (0.0118)|2018_E01 (0.0118)|1042_A06 (0.0118)	0.2353	858_D03 (0.2353)|a total of 4783 cells in this dominant library	STH(0.3176)| GPi(0.2941)| SN(0.1176)| CaT(0.0706)| PuPV(0.0353)| GPeR(0.0353)| CaB(0.0353)| GPeC(0.0235)| NAC(0.0235)| PuC(0.0118)| Pu(0.0118)| PuR(0.0118)| SN-VTA(0.0118)| GPe(0.0)| CaH(0.0)	Balanced	0	0	0	0	0	0	1.5325	2013	4083	2.03
AIT117_273	NN_42		AIT117_359	NK cells	cluster							260	2	['KLRF1', 'NKG7']	['KLRF1', 'GZMB', 'GNLY', 'PYHIN1', 'PRF1', 'NKG7', 'SKAP1', 'CD247', 'TXK', 'KLRD1']	H23.30.001(0.4308)| H18.30.001(0.3462)| H20.30.002(0.1038)| H19.30.004(0.0769)| H20.30.001(0.0423)	Balanced	Balanced	858_D03 (0.1192)|1075_B04 (0.1077)|2013_C01 (0.0500)|925_F03 (0.0385)|2018_C01 (0.0385)|1279_B07 (0.0346)|2006_A05 (0.0346)|2018_B01 (0.0308)|1279_A07 (0.0308)|2012_A05 (0.0308)|988_C05 (0.0308)|2012_B05 (0.0308)|2058_B03 (0.0269)|1959_C02 (0.0269)|2012_C05 (0.0231)|2018_A01 (0.0231)|853_A07 (0.0231)|1959_B02 (0.0231)|853_B07 (0.0231)|1001_B06 (0.0192)|2016_B03 (0.0154)|2058_C03 (0.0154)|2016_C03 (0.0115)|2016_A03 (0.0115)|988_E05 (0.0115)|822_A01 (0.0115)|930_A05 (0.0115)|1955_B06 (0.0115)|1468_A09 (0.0115)	0.1192	858_D03 (0.1192)|a total of 4783 cells in this dominant library	STH(0.2154)| GPi(0.1846)| CaB(0.1)| GPe(0.0731)| CaT(0.0654)| PuPV(0.0654)| SN(0.0538)| PuC(0.0538)| CaH(0.05)| Pu(0.0308)| GPeR(0.0269)| GPeC(0.0231)| NAC(0.0231)| SN-VTA(0.0192)| PuR(0.0154)	Balanced	0	0	0	0	0	0	0.712	1841	3767.5	2.05
AIT117_274	NN_45		AIT117_358	T cells	cluster							206	2	['IL7R', 'LINC00861']	['IL7R', 'CD28', 'TCF7', 'LTB', 'CD6', 'LINC00861', 'ITK', 'SKAP1', 'TC2N', 'ITGA4']	H23.30.001(0.6262)| H18.30.001(0.1893)| H19.30.004(0.0825)| H20.30.001(0.0728)| H20.30.002(0.0291)	Balanced	Balanced	858_D03 (0.0680)|2012_B05 (0.0583)|1075_B04 (0.0583)|2013_A01 (0.0583)|2016_A03 (0.0534)|2018_B01 (0.0485)|2012_C05 (0.0485)|1279_A07 (0.0437)|1959_C02 (0.0388)|1279_B07 (0.0340)|1959_A02 (0.0340)|2016_B03 (0.0340)|2058_B03 (0.0291)|2018_A01 (0.0291)|2013_C01 (0.0291)|2013_B01 (0.0291)|960_B03 (0.0291)|2012_A05 (0.0243)|1959_B02 (0.0243)|2018_C01 (0.0243)|2016_C03 (0.0194)|994_C03 (0.0194)|988_D05 (0.0194)|925_F03 (0.0194)|2058_C03 (0.0146)|2018_E01 (0.0146)|1091_A05 (0.0146)	0.068	858_D03 (0.068)|a total of 4783 cells in this dominant library	GPi(0.233)| STH(0.1699)| GPe(0.1068)| PuPV(0.0874)| CaT(0.0825)| PuC(0.0777)| NAC(0.0534)| Pu(0.0388)| CaB(0.0388)| CaH(0.034)| SN(0.034)| GPeR(0.0291)| SN-VTA(0.0097)| GPeC(0.0049)| PuR(0.0)	Balanced	0	0	0	0	0	0	0.766	1779.5	3583	2.01
AIT117_275	NN_46		AIT117_360	BAM	cluster							451	2	['CCDC26', 'SIGLEC1']	['CCDC26', 'LINC01684', 'MS4A4E', 'SIGLEC1', 'MRC1', 'CD163', 'F13A1', 'AL357522.1', 'LYVE1', 'ADGRG6']	H18.30.001(0.4479)| H23.30.001(0.3259)| H20.30.002(0.1086)| H20.30.001(0.1042)| H19.30.004(0.0133)	Balanced	Balanced	858_D03 (0.1086)|1075_B04 (0.0754)|853_B07 (0.0710)|853_A07 (0.0532)|1959_C02 (0.0288)|1091_A05 (0.0288)|2016_B03 (0.0288)|988_C05 (0.0266)|960_B03 (0.0244)|2012_A05 (0.0244)|2006_B05 (0.0244)|988_D05 (0.0222)|1959_B02 (0.0222)|2058_B03 (0.0222)|988_E05 (0.0222)|925_F03 (0.0222)|2012_B05 (0.0200)|1001_B06 (0.0200)|2013_A01 (0.0177)|2006_A05 (0.0177)|2016_A03 (0.0177)|847_A04 (0.0177)|2013_C01 (0.0155)|1959_A02 (0.0155)|1955_B06 (0.0133)|930_D05 (0.0133)|2018_A01 (0.0133)|847_D04 (0.0111)|1036_C03 (0.0111)|2018_D01 (0.0111)|891_A06 (0.0111)|847_C04 (0.0111)	0.1086	858_D03 (0.1086)|a total of 4783 cells in this dominant library	GPi(0.1796)| STH(0.1153)| NAC(0.0843)| GPeR(0.0776)| PuC(0.071)| GPe(0.071)| GPeC(0.071)| CaH(0.0687)| CaT(0.0643)| CaB(0.0554)| PuPV(0.0466)| Pu(0.0333)| SN(0.0244)| SN-VTA(0.0222)| PuR(0.0155)	Balanced	0	0	0	0	0	0	0.0573	2627	6414	2.44
AIT117_276	NN_47		AIT117_360	BAM	cluster							1013	2	['SIGLEC1', 'F13A1']	['LILRB5', 'SIGLEC1', 'MS4A4A', 'MRC1', 'CD163', 'F13A1', 'DAB2', 'CD163L1', 'SELENOP', 'IQGAP2']	H23.30.001(0.387)| H20.30.001(0.23)| H18.30.001(0.2142)| H20.30.002(0.1175)| H19.30.004(0.0513)	Balanced	Balanced	994_C03 (0.0533)|858_D03 (0.0503)|853_B07 (0.0464)|960_B03 (0.0464)|2058_B03 (0.0405)|2012_A05 (0.0375)|1075_B04 (0.0365)|988_E05 (0.0336)|1001_B06 (0.0336)|1001_A06 (0.0326)|853_A07 (0.0296)|1279_A07 (0.0296)|2013_B01 (0.0257)|2013_A01 (0.0257)|988_C05 (0.0247)|2012_C05 (0.0237)|2016_A03 (0.0237)|2012_B05 (0.0237)|2058_C03 (0.0217)|1959_C02 (0.0217)|1959_B02 (0.0178)|2018_A01 (0.0158)|1279_B07 (0.0148)|2018_B01 (0.0148)|930_D05 (0.0138)|2016_B03 (0.0138)|2006_B05 (0.0128)|891_A06 (0.0128)|2018_E01 (0.0128)|1036_B03 (0.0128)|1959_A02 (0.0118)|988_D05 (0.0118)	0.0533	994_C03 (0.0533)|a total of 4714 cells in this dominant library	GPi(0.1885)| STH(0.1352)| GPe(0.0859)| GPeR(0.076)| CaT(0.075)| NAC(0.0681)| SN-VTA(0.0661)| PuPV(0.0592)| PuC(0.0553)| GPeC(0.0464)| CaH(0.0444)| CaB(0.0375)| SN(0.0276)| Pu(0.0237)| PuR(0.0109)	Balanced	0	0	0	0	0	0.0213	0.0548	2581	6526	2.53
AIT117_277	NN_48		AIT117_348	BN Astrocyte	cluster							629	5	['CPAMD8', 'LINC00836', 'ADAM28', 'APBB1IP', 'DOCK8']	['AL627316.1', 'CPAMD8', 'LINC00836', 'ADAM28', 'APBB1IP', 'DOCK8', 'CD44', 'TNC', 'GFAP', 'MIR4300HG']	H18.30.001(0.5294)| H23.30.001(0.2591)| H20.30.001(0.1192)| H20.30.002(0.0652)| H19.30.004(0.027)	Balanced	Balanced	858_D03 (0.1351)|853_B07 (0.1097)|925_F03 (0.0970)|1075_B04 (0.0715)|980_C02 (0.0413)|988_D05 (0.0413)|891_A06 (0.0350)|2018_D01 (0.0318)|853_A07 (0.0286)|2016_A03 (0.0254)|2018_E01 (0.0238)|988_C05 (0.0238)|1955_C06 (0.0207)|988_E05 (0.0191)|2012_C05 (0.0191)|994_C03 (0.0191)|1955_B06 (0.0159)|2018_C01 (0.0159)|2058_C03 (0.0127)|1001_A06 (0.0127)|2016_C03 (0.0127)|1036_C03 (0.0111)|1468_A09 (0.0111)|1959_A02 (0.0111)|2058_B03 (0.0111)|1959_B02 (0.0111)	0.1351	858_D03 (0.1351)|a total of 4783 cells in this dominant library	GPi(0.2242)| CaT(0.1494)| STH(0.1145)| SN(0.1113)| GPeC(0.1097)| PuPV(0.0509)| CaB(0.0445)| GPeR(0.0366)| CaH(0.035)| NAC(0.0334)| GPe(0.0318)| Pu(0.0286)| SN-VTA(0.0207)| PuC(0.0079)| PuR(0.0016)	Balanced	0	0.5	0	0.24	0.24	0.1163	0.095	4104	10057	2.45
AIT117_278	NN_49		AIT117_348	BN Astrocyte	cluster							672	5	['ADAM28', 'DOCK8', 'AC097518.2', 'STK32A', 'TNC']	['LGR6', 'ADAM28', 'DOCK8', 'AC097518.2', 'STK32A', 'TNC', 'HPSE2', 'SLC6A11', 'AC012405.1', 'LINC00299']	H18.30.001(0.619)| H23.30.001(0.1384)| H20.30.001(0.1027)| H19.30.004(0.0744)| H20.30.002(0.0655)	Balanced	Balanced	853_B07 (0.2574)|858_D03 (0.2173)|994_C03 (0.0595)|1279_B07 (0.0491)|925_F03 (0.0476)|2016_A03 (0.0476)|1075_B04 (0.0461)|853_A07 (0.0461)|1169_A01 (0.0268)|2058_C03 (0.0238)|1279_A07 (0.0223)|960_B03 (0.0179)|988_E05 (0.0179)|2006_B05 (0.0164)|1001_B06 (0.0134)|2012_A05 (0.0104)	0.2574	853_B07 (0.2574)|a total of 2788 cells in this dominant library	GPi(0.3497)| GPeC(0.2574)| STH(0.1607)| SN(0.0729)| GPeR(0.064)| GPe(0.0387)| PuPV(0.0193)| SN-VTA(0.0149)| NAC(0.0149)| PuC(0.006)| CaT(0.0015)| CaB(0.0)| CaH(0.0)| Pu(0.0)| PuR(0.0)	Balanced	0	0.5	0	0	0	0.1471	0.0747	4828.5	13460.5	2.79
AIT117_279	NN_50		AIT117_348	BN Astrocyte	cluster							462	5	['GEM', 'AL096709.1', 'LINC01727', 'AL627316.1', 'BLNK']	['GEM', 'AC104574.2', 'AL096709.1', 'LINC01727', 'AL627316.1', 'BLNK', 'WDFY4', 'ADAM28', 'CD53', 'SYK']	H18.30.001(0.8506)| H23.30.001(0.0541)| H20.30.001(0.039)| H19.30.004(0.0368)| H20.30.002(0.0195)	Balanced	Balanced	853_B07 (0.4286)|925_F03 (0.2013)|853_A07 (0.0952)|891_A06 (0.0519)|858_D03 (0.0455)|2012_A05 (0.0238)|1279_A07 (0.0173)|1279_B07 (0.0152)|1075_B04 (0.0152)|988_E05 (0.0130)|1477_A07 (0.0108)|960_B03 (0.0108)	0.4286	853_B07 (0.4286)|a total of 2788 cells in this dominant library	GPeC(0.4286)| SN(0.2078)| GPeR(0.1061)| GPi(0.0693)| STH(0.0563)| CaB(0.0519)| GPe(0.0303)| PuPV(0.0195)| CaT(0.0173)| SN-VTA(0.0043)| NAC(0.0043)| PuC(0.0043)| CaH(0.0)| Pu(0.0)| PuR(0.0)	Balanced	0	0	0	0	0	0.1765	0.0898	7284.5	29166.5	4
AIT117_280	NN_51		AIT117_348	BN Astrocyte	cluster							185	4	['F13A1', 'LYVE1', 'RBM47', 'ARHGAP15']	['F13A1', 'LYVE1', 'TNFAIP8', 'RBM47', 'PTPRC', 'ARHGAP15', 'IQGAP2', 'SELENOP', 'EDA', 'HPSE2']	H18.30.001(0.4703)| H23.30.001(0.2324)| H20.30.001(0.227)| H20.30.002(0.0378)| H19.30.004(0.0324)	Balanced	Balanced	853_B07 (0.1514)|988_E05 (0.1027)|891_A06 (0.0811)|925_F03 (0.0811)|988_D05 (0.0595)|930_D05 (0.0378)|2016_C03 (0.0378)|858_D03 (0.0324)|1075_B04 (0.0270)|960_B03 (0.0216)|2006_A05 (0.0216)|1279_A07 (0.0216)|1959_B02 (0.0162)|2058_B03 (0.0162)|930_F05 (0.0162)|2012_B05 (0.0162)|1001_A06 (0.0162)|2012_A05 (0.0108)|2012_C05 (0.0108)|2016_B03 (0.0108)|847_D04 (0.0108)|2018_A01 (0.0108)|1955_C06 (0.0108)|930_C05 (0.0108)|988_C05 (0.0108)|2016_A03 (0.0108)|1169_A01 (0.0108)|1959_C02 (0.0108)|853_A07 (0.0108)	0.1514	853_B07 (0.1514)|a total of 2788 cells in this dominant library	GPeC(0.1514)| PuPV(0.1514)| CaB(0.1135)| CaT(0.0919)| SN(0.0865)| STH(0.0865)| GPi(0.0757)| PuC(0.0703)| CaH(0.0324)| GPeR(0.0324)| NAC(0.027)| GPe(0.0216)| Pu(0.0216)| SN-VTA(0.0216)| PuR(0.0162)	Balanced	0	0.58	0	0.24	0.24	0.1	0.1234	4334	10812	2.49
AIT117_281	NN_52		AIT117_361	STR Astrocyte	cluster							515	4	['WIF1', 'APBB1IP', 'AC068308.1', 'DOCK8']	['WIF1', 'ADAM28', 'FYB1', 'APBB1IP', 'AC068308.1', 'DOCK8', 'RHOJ', 'ZNF98', 'GNA14', 'ADGRV1']	H18.30.001(0.4252)| H20.30.001(0.2078)| H23.30.001(0.1883)| H20.30.002(0.1786)| H19.30.004(0.0)	Balanced	Balanced	891_A06 (0.1456)|988_D05 (0.1126)|988_E05 (0.0621)|1036_A03 (0.0544)|1091_A05 (0.0408)|2018_A01 (0.0350)|1110_B07 (0.0311)|2016_C03 (0.0311)|925_F03 (0.0272)|1042_C06 (0.0272)|897_E03 (0.0252)|1042_B06 (0.0252)|2016_B03 (0.0233)|930_C05 (0.0233)|1036_C03 (0.0233)|980_C02 (0.0233)|1110_A07 (0.0214)|1042_A06 (0.0214)|853_B07 (0.0214)|2018_B01 (0.0194)|1036_B03 (0.0194)|1955_C06 (0.0194)|930_E05 (0.0155)|988_C05 (0.0155)|930_B05 (0.0155)|2006_A05 (0.0136)|930_F05 (0.0117)|2006_B05 (0.0117)	0.1456	891_A06 (0.1456)|a total of 2500 cells in this dominant library	NAC(0.268)| CaB(0.2019)| CaT(0.1592)| PuPV(0.1223)| PuC(0.0816)| CaH(0.0466)| SN(0.0272)| Pu(0.0252)| PuR(0.0214)| GPeC(0.0214)| GPe(0.0175)| GPi(0.0039)| GPeR(0.0039)| SN-VTA(0.0)| STH(0.0)	Balanced	0	0.24	0	0	0	0.0789	0.0732	3714	8600	2.32
AIT117_282	NN_54		AIT117_348	BN Astrocyte	cluster							200	5	['LINC01608', 'APBB1IP', 'DOCK8', 'ETNPPL', 'OBI1-AS1']	['LINC01608', 'APBB1IP', 'DOCK8', 'ETNPPL', 'RGMA', 'OBI1-AS1', 'RNF220', 'AC012405.1', 'HPSE2', 'EFEMP1']	H23.30.001(0.675)| H18.30.001(0.18)| H20.30.001(0.055)| H19.30.004(0.05)| H20.30.002(0.04)	Balanced	Balanced	2018_D01 (0.2050)|2016_C03 (0.1000)|1955_B06 (0.0850)|988_D05 (0.0750)|1091_A05 (0.0650)|2016_B03 (0.0650)|1279_A07 (0.0350)|1959_C02 (0.0350)|2018_C01 (0.0300)|2016_A03 (0.0300)|1955_C06 (0.0250)|2018_B01 (0.0200)|1959_B02 (0.0200)|925_F03 (0.0150)|2018_A01 (0.0150)|822_B01 (0.0150)|994_C03 (0.0150)|988_E05 (0.0150)	0.205	2018_D01 (0.205)|a total of 2261 cells in this dominant library	GPi(0.255)| PuPV(0.15)| CaH(0.11)| NAC(0.09)| CaT(0.085)| PuC(0.08)| STH(0.07)| Pu(0.06)| GPe(0.035)| SN(0.03)| CaB(0.015)| PuR(0.01)| GPeC(0.005)| SN-VTA(0.005)| GPeR(0.0)	Balanced	0	0.5	0	0	0	0.1072	0.0465	4490.5	11542.5	2.57
AIT117_283	NN_55		AIT117_362	ImOligo	cluster							891	4	['ADAM28', 'DOCK8', 'ENPP2', 'C10orf90']	['ADAM28', 'APBB1IP', 'DOCK8', 'ENPP2', 'C10orf90', 'AC008691.1', 'RNF220', 'KCNH8', 'PLP1', 'ST18']	H23.30.001(0.5982)| H20.30.002(0.1246)| H19.30.004(0.11)| H20.30.001(0.0875)| H18.30.001(0.0797)	Balanced	Balanced	2018_D01 (0.1425)|2016_C03 (0.1044)|2006_A05 (0.0629)|1279_A07 (0.0561)|1279_B07 (0.0494)|2016_B03 (0.0483)|1169_A01 (0.0292)|994_C03 (0.0269)|2018_A01 (0.0236)|2012_C05 (0.0202)|2018_B01 (0.0202)|2016_A03 (0.0180)|1036_C03 (0.0168)|2018_E01 (0.0168)|822_A01 (0.0157)|1477_A07 (0.0157)|1959_B02 (0.0157)|1042_C06 (0.0157)|1458_A09 (0.0146)|2013_A01 (0.0135)|2018_C01 (0.0135)|1955_B06 (0.0135)|1482_A03 (0.0123)|1091_A05 (0.0112)|2012_A05 (0.0112)|988_D05 (0.0112)|1110_B07 (0.0112)|2058_C03 (0.0101)|2006_B05 (0.0101)|980_C02 (0.0101)|1075_B04 (0.0101)|2058_B03 (0.0101)|847_A04 (0.0101)	0.1425	2018_D01 (0.1425)|a total of 2261 cells in this dominant library	GPi(0.2357)| STH(0.174)| PuPV(0.1358)| NAC(0.0842)| PuC(0.0763)| CaB(0.0741)| CaT(0.0606)| GPe(0.0483)| CaH(0.0404)| PuR(0.0224)| SN(0.018)| Pu(0.0157)| SN-VTA(0.0079)| GPeR(0.0056)| GPeC(0.0011)	Balanced	0	0.5	0	0.5	0.5	0.12	0.0661	2981	6966	2.34
AIT117_284	NN_56		AIT117_361	STR Astrocyte	cluster							522	4	['WIF1', 'LINC00639', 'MOBP', 'ENPP2']	['WIF1', 'LINC01608', 'LINC00639', 'MOBP', 'ENPP2', 'UGT8', 'OBI1-AS1', 'KCNH8', 'RNF220', 'PLP1']	H23.30.001(0.3966)| H18.30.001(0.341)| H20.30.002(0.136)| H20.30.001(0.1169)| H19.30.004(0.0096)	Balanced	Balanced	2018_A01 (0.1130)|2016_B03 (0.1054)|2016_C03 (0.0862)|1110_B07 (0.0805)|988_D05 (0.0766)|988_E05 (0.0556)|1091_A05 (0.0517)|847_A04 (0.0479)|822_A01 (0.0421)|847_D04 (0.0307)|1042_B06 (0.0287)|1110_A07 (0.0230)|1036_C03 (0.0211)|1036_A03 (0.0211)|2018_B01 (0.0172)|1042_A06 (0.0172)|1042_C06 (0.0172)|822_B01 (0.0153)|897_E03 (0.0134)|1955_B06 (0.0115)|847_B04 (0.0115)	0.113	2018_A01 (0.113)|a total of 7432 cells in this dominant library	NAC(0.2759)| PuC(0.251)| PuPV(0.1839)| CaT(0.0939)| CaH(0.0651)| PuR(0.0556)| CaB(0.0326)| Pu(0.0115)| STH(0.0115)| GPe(0.0096)| GPi(0.0057)| SN(0.0038)| GPeC(0.0)| GPeR(0.0)| SN-VTA(0.0)	Balanced	0	0.58	0	0	0	0.0863	0.0492	3791	9664.5	2.55
AIT117_285	NN_57		AIT117_348	BN Astrocyte	cluster							649	2	['SLC26A3', 'TNC']	['AL355612.1', 'SLC26A3', 'AC124854.1', 'TNC', 'LAMA1', 'OBI1-AS1', 'APOE', 'HPSE2', 'AC012405.1', 'GLI3']	H23.30.001(0.7596)| H20.30.001(0.1032)| H20.30.002(0.1017)| H18.30.001(0.0277)| H19.30.004(0.0077)	Balanced	Balanced	2058_C03 (0.6009)|2058_B03 (0.0770)|1001_A06 (0.0678)|1169_A01 (0.0586)|2012_B05 (0.0308)|1001_B06 (0.0277)|2013_B01 (0.0185)|960_B03 (0.0154)|2016_A03 (0.0123)|994_C03 (0.0108)	0.6009	2058_C03 (0.6009)|a total of 4967 cells in this dominant library	SN(0.6102)| STH(0.151)| SN-VTA(0.0955)| GPi(0.0786)| GPe(0.0185)| GPeR(0.0154)| PuPV(0.0139)| NAC(0.0046)| CaT(0.0046)| GPeC(0.0031)| CaB(0.0015)| PuC(0.0015)| Pu(0.0015)| CaH(0.0)| PuR(0.0)	Balanced	0	0	0	0	0	0.02	0.0517	3102	7044	2.27
AIT117_286	NN_58		AIT117_348	BN Astrocyte	cluster							270	2	['CPAMD8', 'MATN2']	['CPAMD8', 'CD99', 'GYG2', 'AHNAK', 'MATN2', 'MIR4300HG', 'WDR49', 'MYO5C', 'ZBTB7C', 'ST6GAL1']	H20.30.001(0.4926)| H20.30.002(0.2296)| H23.30.001(0.1333)| H18.30.001(0.0852)| H19.30.004(0.0593)	Balanced	Balanced	1001_A06 (0.4111)|1001_B06 (0.1630)|988_C05 (0.0556)|2058_C03 (0.0444)|858_D03 (0.0407)|2016_A03 (0.0370)|960_B03 (0.0296)|1279_A07 (0.0259)|925_F03 (0.0259)|994_C03 (0.0222)|1075_B04 (0.0185)|2058_B03 (0.0185)|1279_B07 (0.0185)|2012_B05 (0.0148)|1468_A09 (0.0148)|988_E05 (0.0148)|1482_A03 (0.0111)	0.4111	1001_A06 (0.4111)|a total of 3218 cells in this dominant library	SN-VTA(0.5741)| GPi(0.1296)| STH(0.1037)| SN(0.0704)| CaT(0.063)| GPeR(0.0296)| PuPV(0.0148)| GPe(0.0111)| CaB(0.0037)| GPeC(0.0)| CaH(0.0)| PuC(0.0)| Pu(0.0)| NAC(0.0)| PuR(0.0)	Balanced	0	0	0	0	0	0.037	0.1147	2172	4409	2.03
AIT117_287	NN_59		AIT117_348	BN Astrocyte	cluster							309	3	['AC090809.1', 'AC019068.1', 'NTN1']	['AC090809.1', 'AC009975.1', 'AC019068.1', 'NTN1', 'OBI1-AS1', 'HPSE2', 'APOE', 'DOCK5', 'SHROOM3', 'TTN']	H20.30.002(0.6731)| H20.30.001(0.2201)| H18.30.001(0.0744)| H23.30.001(0.0259)| H19.30.004(0.0065)	Balanced	Balanced	1001_B06 (0.6731)|1001_A06 (0.2136)|925_F03 (0.0518)|1075_B04 (0.0194)	0.6731	1001_B06 (0.6731)|a total of 3982 cells in this dominant library	SN-VTA(0.8867)| SN(0.0615)| STH(0.0356)| GPi(0.0162)| CaT(0.0)| CaH(0.0)| CaB(0.0)| GPeR(0.0)| GPeC(0.0)| GPe(0.0)| NAC(0.0)| PuPV(0.0)| PuC(0.0)| Pu(0.0)| PuR(0.0)	Balanced	0	0	0	0	0	0.037	0.0753	3679	10974	2.98
AIT117_288	NN_60		AIT117_348	BN Astrocyte	cluster							382	2	['TRDN', 'LINC01094']	['TRDN', 'LRAT', 'GALNT3', 'RERGL', 'LINC01094', 'STOM', 'CRYAB', 'LINC01088', 'MIR4300HG', 'ST6GAL1']	H18.30.001(0.2539)| H19.30.004(0.2356)| H23.30.001(0.2147)| H20.30.001(0.2016)| H20.30.002(0.0942)	Balanced	Balanced	1468_A09 (0.2356)|925_F03 (0.2173)|980_C02 (0.0995)|1001_A06 (0.0759)|2058_C03 (0.0759)|1001_B06 (0.0707)|2016_A03 (0.0366)|2018_D01 (0.0314)|2012_B05 (0.0288)|858_D03 (0.0236)|988_C05 (0.0236)|1482_A03 (0.0183)|2013_C01 (0.0131)|1075_B04 (0.0105)|2012_A05 (0.0105)	0.2356	1468_A09 (0.2356)|a total of 3319 cells in this dominant library	SN(0.2932)| STH(0.2487)| SN-VTA(0.1466)| GPi(0.1414)| CaT(0.1335)| CaB(0.0157)| GPe(0.0105)| GPeR(0.0026)| GPeC(0.0026)| CaH(0.0026)| PuR(0.0026)| PuPV(0.0)| PuC(0.0)| Pu(0.0)| NAC(0.0)	Balanced	0	0	0	0	0	0	0.033	2817	6624	2.35
AIT117_289	NN_61		AIT117_348	BN Astrocyte	cluster							664	4	['STON1', 'AEBP1', 'CPXM2', 'HLA-E']	['STON1', 'AC019068.1', 'AEBP1', 'CPXM2', 'HLA-E', 'NTN1', 'GYG2', 'MATN2', 'WDR49', 'FRMPD3']	H20.30.001(0.6069)| H20.30.002(0.262)| H18.30.001(0.0648)| H23.30.001(0.0407)| H19.30.004(0.0256)	Balanced	Balanced	1001_A06 (0.6009)|1001_B06 (0.2620)|925_F03 (0.0467)|1468_A09 (0.0241)|2058_B03 (0.0120)|858_D03 (0.0105)	0.6009	1001_A06 (0.6009)|a total of 3218 cells in this dominant library	SN-VTA(0.863)| SN(0.0527)| STH(0.0437)| GPi(0.0286)| GPe(0.006)| GPeR(0.003)| CaT(0.0015)| GPeC(0.0015)| CaH(0.0)| CaB(0.0)| NAC(0.0)| PuPV(0.0)| PuC(0.0)| Pu(0.0)| PuR(0.0)	Balanced	0	0	0	0	0	0.037	0.1056	3963	10835	2.73
AIT117_290	NN_62		AIT117_348	BN Astrocyte	cluster							745	3	['AC090809.1', 'KCNJ16', 'LGR6']	['ITPRID1', 'AC090809.1', 'AC009975.1', 'KCNJ16', 'LGR6', 'LINC00499', 'LINC00278', 'NTN1', 'STK32A', 'MKX']	H20.30.002(0.8242)| H20.30.001(0.1235)| H18.30.001(0.0282)| H19.30.004(0.0148)| H23.30.001(0.0094)	Balanced	Balanced	1001_B06 (0.8242)|1001_A06 (0.1221)|1468_A09 (0.0148)|925_F03 (0.0134)	0.8242	1001_B06 (0.8242)|a total of 3982 cells in this dominant library	SN-VTA(0.9463)| STH(0.0268)| SN(0.0134)| GPi(0.0067)| GPeC(0.004)| GPeR(0.0013)| GPe(0.0013)| CaH(0.0)| CaB(0.0)| CaT(0.0)| NAC(0.0)| PuPV(0.0)| PuC(0.0)| Pu(0.0)| PuR(0.0)	Balanced	0	0	0	0	0	0.0189	0.0705	4308	13048	3.03
AIT117_291	NN_63		AIT117_348	BN Astrocyte	cluster							1027	4	['SOCS3', 'PIRT', 'C11orf96', 'COL27A1']	['SOCS3', 'PIRT', 'CCL2', 'CPXM2', 'C11orf96', 'COL27A1', 'C4orf19', 'ETS1', 'NTN1', 'MATN2']	H20.30.001(0.8754)| H20.30.002(0.0818)| H18.30.001(0.0195)| H23.30.001(0.0175)| H19.30.004(0.0058)	Balanced	Balanced	1001_A06 (0.8656)|1001_B06 (0.0779)|925_F03 (0.0107)	0.8656	1001_A06 (0.8656)|a total of 3218 cells in this dominant library	SN-VTA(0.9435)| GPi(0.0204)| SN(0.0175)| STH(0.0107)| GPe(0.0039)| GPeR(0.0029)| PuPV(0.001)| GPeC(0.0)| CaB(0.0)| CaH(0.0)| CaT(0.0)| PuC(0.0)| Pu(0.0)| NAC(0.0)| PuR(0.0)	Balanced	0	0	0	0	0	0.0185	0.1546	3481	9239	2.65
AIT117_292	NN_64		AIT117_349	Oligo RBFOX1	cluster							672	4	['AC004690.2', 'SLC26A3', 'STEAP1B', 'AC092924.2']	['AC004690.2', 'SLC26A3', 'STEAP1B', 'AC092924.2', 'SCD', 'CRYAB', 'AC008571.2', 'LINC00609', 'ST18', 'SLC7A11']	H23.30.001(0.9524)| H20.30.001(0.0268)| H20.30.002(0.0119)| H18.30.001(0.0045)| H19.30.004(0.0045)	Cautious	Balanced	2058_C03 (0.6042)|2058_B03 (0.3051)|1001_A06 (0.0134)|2016_A03 (0.0104)	0.6042	2058_C03 (0.6042)|a total of 4967 cells in this dominant library	SN(0.6101)| STH(0.3155)| GPi(0.0268)| GPe(0.0193)| SN-VTA(0.0179)| PuPV(0.006)| CaT(0.003)| PuR(0.0015)| GPeC(0.0)| CaB(0.0)| CaH(0.0)| GPeR(0.0)| PuC(0.0)| NAC(0.0)| Pu(0.0)	Balanced	0	0	0	0	0	0.01	0.0187	4150	16090.5	3.88
AIT117_293	NN_65		AIT117_350	Oligo OPALIN	cluster							2164	5	['LINC01792', 'SLC26A3', 'STEAP1B', 'OPALIN', 'LINC01608']	['LINC01792', 'SLC26A3', 'STEAP1B', 'OPALIN', 'LINC01608', 'APOD', 'HHIP', 'KCNH8', 'RNF220', 'PLP1']	H23.30.001(0.9228)| H20.30.001(0.055)| H20.30.002(0.012)| H18.30.001(0.0074)| H19.30.004(0.0028)	Cautious	Balanced	2058_C03 (0.6617)|2058_B03 (0.1701)|1001_A06 (0.0360)|2016_A03 (0.0250)|2013_B01 (0.0148)|994_C03 (0.0106)	0.6617	2058_C03 (0.6617)|a total of 4967 cells in this dominant library	SN(0.6645)| STH(0.1788)| GPi(0.0642)| SN-VTA(0.0397)| GPe(0.0152)| CaT(0.0139)| NAC(0.0106)| PuPV(0.0088)| Pu(0.0014)| CaH(0.0009)| GPeR(0.0009)| PuC(0.0009)| CaB(0.0)| GPeC(0.0)| PuR(0.0)	Balanced	0	0	0	0	0	0	0.0371	3195.5	9653.5	3.02
AIT117_294	NN_66		AIT117_349	Oligo RBFOX1	cluster							276	5	['AC114485.1', 'SLC26A3', 'COL18A1', 'AC012494.1', 'PRTG']	['AC114485.1', 'SLC26A3', 'COL18A1', 'AC012494.1', 'PRTG', 'CRYAB', 'LINC00609', 'PLP1', 'LINC01515', 'PTGDS']	H23.30.001(0.9275)| H20.30.001(0.0652)| H20.30.002(0.0072)| H18.30.001(0.0)| H19.30.004(0.0)	Cautious	Balanced	2058_C03 (0.8551)|2058_B03 (0.0471)|994_C03 (0.0326)|1001_A06 (0.0290)|2016_A03 (0.0109)	0.8551	2058_C03 (0.8551)|a total of 4967 cells in this dominant library	SN(0.8551)| GPi(0.0543)| STH(0.0507)| SN-VTA(0.0326)| GPeR(0.0036)| CaH(0.0036)| CaT(0.0)| GPe(0.0)| GPeC(0.0)| CaB(0.0)| NAC(0.0)| PuPV(0.0)| PuC(0.0)| Pu(0.0)| PuR(0.0)	Balanced	0	0	0	0	0	0.02	0.0165	5028.5	23718.5	4.72
AIT117_295	NN_67		AIT117_361	STR Astrocyte	cluster							3751	3	['AL137139.2', 'AL133304.3', 'TNC']	['AC083864.5', 'AL137139.2', 'AL133304.3', 'TNC', 'ADAMTS9', 'GALNT15', 'GFAP', 'AC073941.1', 'LINC00609', 'AC012405.1']	H23.30.001(0.5481)| H20.30.002(0.2677)| H20.30.001(0.093)| H18.30.001(0.0885)| H19.30.004(0.0027)	Balanced	Balanced	2012_C05 (0.2298)|988_C05 (0.1610)|822_B01 (0.0730)|1959_A02 (0.0682)|1959_B02 (0.0491)|988_E05 (0.0485)|2018_E01 (0.0352)|1959_C02 (0.0325)|988_D05 (0.0245)|2018_C01 (0.0221)|2018_B01 (0.0205)|1955_B06 (0.0176)|1091_A05 (0.0160)|2013_C01 (0.0149)|1042_C06 (0.0101)	0.2298	2012_C05 (0.2298)|a total of 5802 cells in this dominant library	CaT(0.4575)| PuPV(0.1565)| NAC(0.1165)| CaH(0.073)| Pu(0.0392)| GPe(0.0373)| GPi(0.0296)| CaB(0.028)| PuC(0.0235)| PuR(0.0131)| STH(0.0096)| SN(0.0064)| GPeR(0.0051)| GPeC(0.0048)| SN-VTA(0.0)	Balanced	0	0	0	0	0	0	0.0403	2461	4910	2
AIT117_296	NN_68		AIT117_361	STR Astrocyte	cluster							1573	3	['PTCSC3', 'AL137139.2', 'HSPA1B']	['LRAT', 'PTCSC3', 'ARMC3', 'HSPB8', 'AL137139.2', 'HSPA1B', 'HSPA1A', 'MIR4300HG', 'LINC00609', 'CFAP47']	H23.30.001(0.7069)| H20.30.001(0.1271)| H18.30.001(0.1227)| H20.30.002(0.0375)| H19.30.004(0.0057)	Balanced	Balanced	2012_C05 (0.2250)|2018_E01 (0.2104)|2013_C01 (0.0935)|1955_B06 (0.0757)|891_A06 (0.0687)|980_C02 (0.0591)|930_C05 (0.0362)|1959_B02 (0.0331)|1959_A02 (0.0286)|988_C05 (0.0235)|925_F03 (0.0191)|847_A04 (0.0146)|2006_A05 (0.0127)|1482_A03 (0.0102)	0.225	2012_C05 (0.225)|a total of 5802 cells in this dominant library	CaT(0.5207)| CaB(0.1844)| CaH(0.1596)| NAC(0.0509)| GPi(0.0273)| PuPV(0.0197)| SN(0.0197)| STH(0.0057)| GPe(0.0051)| GPeR(0.0038)| PuC(0.0019)| PuR(0.0006)| Pu(0.0006)| GPeC(0.0)| SN-VTA(0.0)	Balanced	0	0	0	0	0	0	0.0216	2630	5749	2.19
AIT117_297	NN_69		AIT117_361	STR Astrocyte	cluster							286	2	['AL157886.1', 'SERPINA3']	['AL157886.1', 'LRAT', 'SERPINA3', 'LDLR', 'FABP5', 'PMP2', 'CD44', 'BMPR1B', 'CNN3', 'LRIG1']	H20.30.001(0.7308)| H23.30.001(0.1923)| H18.30.001(0.0734)| H20.30.002(0.0035)| H19.30.004(0.0)	Balanced	Balanced	980_C02 (0.5804)|2013_C01 (0.0839)|930_E05 (0.0769)|891_A06 (0.0559)|930_C05 (0.0490)|2018_E01 (0.0315)|2012_C05 (0.0315)|1955_B06 (0.0140)|1959_B02 (0.0105)|847_A04 (0.0105)|988_E05 (0.0105)|1042_B06 (0.0105)	0.5804	980_C02 (0.5804)|a total of 6906 cells in this dominant library	CaT(0.6503)| CaB(0.2238)| CaH(0.0839)| NAC(0.021)| PuPV(0.014)| GPi(0.007)| GPe(0.0)| GPeR(0.0)| GPeC(0.0)| Pu(0.0)| PuC(0.0)| PuR(0.0)| SN(0.0)| SN-VTA(0.0)| STH(0.0)	Balanced	0	0	0	0	0	0	0.0217	2257	5391	2.39
AIT117_298	NN_70		AIT117_361	STR Astrocyte	cluster							228	5	['CPAMD8', 'OAF', 'AL137139.2', 'MOXD1', 'RHOJ']	['CTSH', 'CPAMD8', 'OAF', 'AL137139.2', 'MOXD1', 'RHOJ', 'ZNF98', 'SLCO1C1', 'LINC00609', 'GLI3']	H18.30.001(0.3114)| H20.30.002(0.2851)| H23.30.001(0.2456)| H20.30.001(0.1579)| H19.30.004(0.0)	Balanced	Balanced	988_C05 (0.2193)|988_D05 (0.1096)|891_A06 (0.1053)|2012_C05 (0.0877)|988_E05 (0.0833)|2018_E01 (0.0482)|822_B01 (0.0482)|1091_A05 (0.0395)|980_C02 (0.0351)|925_F03 (0.0263)|1959_A02 (0.0263)|2016_C03 (0.0175)|930_E05 (0.0132)|853_B07 (0.0132)|2018_C01 (0.0132)	0.2193	988_C05 (0.2193)|a total of 5279 cells in this dominant library	CaT(0.5)| PuPV(0.1623)| CaB(0.1272)| NAC(0.0746)| SN(0.0263)| GPe(0.0219)| CaH(0.0219)| PuC(0.0175)| PuR(0.0132)| GPeC(0.0132)| GPi(0.0088)| Pu(0.0088)| STH(0.0044)| GPeR(0.0)| SN-VTA(0.0)	Balanced	0	0	0	0	0	0.0698	0.0461	4375.5	11817	2.7
AIT117_299	NN_71		AIT117_352	OPC	cluster							967	2	['SNX22', 'BEST3']	['SNX22', 'AC004852.2', 'BX284613.2', 'BEST3', 'VCAN', 'MEGF11', 'SEMA3E', 'HIP1R', 'CA10', 'PTPRZ1']	H23.30.001(0.7839)| H20.30.001(0.0931)| H20.30.002(0.0724)| H18.30.001(0.0476)| H19.30.004(0.0031)	Balanced	Balanced	2012_C05 (0.2813)|1959_C02 (0.0558)|2013_C01 (0.0496)|1959_A02 (0.0465)|2018_E01 (0.0465)|822_B01 (0.0445)|1959_B02 (0.0414)|1955_C06 (0.0341)|2016_C03 (0.0321)|2018_B01 (0.0300)|1482_A03 (0.0290)|2013_A01 (0.0269)|1955_B06 (0.0259)|2016_B03 (0.0196)|2018_A01 (0.0196)|1091_A05 (0.0196)|2006_B05 (0.0186)|2018_C01 (0.0176)|1042_C06 (0.0176)|2006_A05 (0.0176)|988_E05 (0.0165)|988_C05 (0.0124)|2018_D01 (0.0114)|822_A01 (0.0103)|980_C02 (0.0103)	0.2813	2012_C05 (0.2813)|a total of 5802 cells in this dominant library	CaT(0.3506)| PuPV(0.1313)| NAC(0.0982)| Pu(0.09)| CaB(0.0776)| CaH(0.0703)| GPe(0.0631)| GPi(0.0496)| PuC(0.0403)| PuR(0.0165)| STH(0.0041)| SN(0.0031)| GPeC(0.0021)| SN-VTA(0.0021)| GPeR(0.001)	Balanced	0	0	0	0	0	0	0.0339	2298	4717	2.05
AIT117_300	NN_72		AIT117_352	OPC	cluster							844	2	['MIR3681HG', 'BCAN']	['AL450345.2', 'MIR3681HG', 'AC004852.2', 'COL9A1', 'BCAN', 'LINC02328', 'APOD', 'ATP10B', 'PTPRZ1', 'NELL1']	H23.30.001(0.3839)| H20.30.002(0.3507)| H18.30.001(0.1908)| H20.30.001(0.0735)| H19.30.004(0.0012)	Balanced	Balanced	822_B01 (0.1351)|822_A01 (0.0960)|1955_B06 (0.0841)|847_A04 (0.0794)|1036_A03 (0.0604)|1959_C02 (0.0509)|2006_A05 (0.0379)|1959_B02 (0.0344)|1042_A06 (0.0320)|847_D04 (0.0273)|1042_C06 (0.0261)|1036_C03 (0.0249)|1959_A02 (0.0225)|2016_C03 (0.0213)|988_D05 (0.0201)|2016_B03 (0.0190)|1955_C06 (0.0190)|847_C04 (0.0190)|2018_A01 (0.0154)|1091_A05 (0.0154)|2018_B01 (0.0142)|2018_C01 (0.0142)|2013_C01 (0.0142)|1042_B06 (0.0130)|1036_B03 (0.0118)	0.1351	822_B01 (0.1351)|a total of 6920 cells in this dominant library	NAC(0.2097)| CaH(0.2002)| PuPV(0.1931)| PuR(0.1043)| Pu(0.0699)| PuC(0.0628)| CaB(0.0592)| CaT(0.0355)| GPe(0.0284)| GPi(0.0201)| SN(0.0095)| GPeR(0.0036)| STH(0.0024)| SN-VTA(0.0012)| GPeC(0.0)	Balanced	0	0	0	0	0	0	0.1574	2774	6282	2.26
AIT117_301	NN_73		AIT117_352	OPC	cluster							974	2	['MIR3681HG', 'LINC02328']	['AL450345.2', 'MIR3681HG', 'AC004852.2', 'COL9A1', 'AC124254.2', 'LINC02328', 'PDGFRA', 'AL353784.1', 'ATP10B', 'PTPRZ1']	H23.30.001(0.5554)| H18.30.001(0.1807)| H20.30.002(0.1427)| H20.30.001(0.1201)| H19.30.004(0.001)	Balanced	Balanced	1959_B02 (0.0821)|1955_B06 (0.0801)|1959_A02 (0.0739)|822_A01 (0.0585)|847_A04 (0.0493)|1959_C02 (0.0483)|1482_A03 (0.0472)|2006_A05 (0.0411)|2016_B03 (0.0390)|2018_A01 (0.0359)|1036_B03 (0.0349)|1091_A05 (0.0329)|2018_B01 (0.0329)|2016_C03 (0.0308)|1036_A03 (0.0298)|1110_A07 (0.0277)|822_B01 (0.0267)|847_C04 (0.0226)|1042_B06 (0.0175)|1110_B07 (0.0175)|1042_A06 (0.0154)|847_B04 (0.0154)|2013_C01 (0.0144)|2013_A01 (0.0133)|2012_B05 (0.0133)	0.0821	1959_B02 (0.0821)|a total of 7977 cells in this dominant library	NAC(0.2659)| CaH(0.2125)| PuPV(0.115)| PuC(0.076)| CaB(0.0749)| PuR(0.0739)| GPi(0.0708)| Pu(0.0534)| GPe(0.0287)| CaT(0.0236)| SN(0.0021)| STH(0.0021)| GPeR(0.001)| GPeC(0.0)| SN-VTA(0.0)	Balanced	0	0	0	0	0	0	0.0241	2865	6918.5	2.41
AIT117_302	NN_74		AIT117_363	Ependymal	cluster							2627	2	['ADGB', 'AC020718.1']	['ADGB', 'DNAH12', 'AC020718.1', 'AC019330.1', 'SPATA17', 'DNAH11', 'SPAG17', 'CFAP299', 'ARMC3', 'CFAP47']	H23.30.001(0.8618)| H20.30.001(0.1051)| H18.30.001(0.0301)| H19.30.004(0.0015)| H20.30.002(0.0015)	Balanced	Balanced	2018_E01 (0.4393)|2013_C01 (0.1625)|2012_C05 (0.1039)|980_C02 (0.0807)|1955_B06 (0.0620)|1959_B02 (0.0571)|891_A06 (0.0236)|1959_A02 (0.0206)|2006_A05 (0.0152)|930_E05 (0.0122)	0.4393	2018_E01 (0.4393)|a total of 6375 cells in this dominant library	CaT(0.6247)| CaB(0.2139)| CaH(0.1313)| NAC(0.0228)| STH(0.0019)| GPi(0.0015)| SN(0.0015)| GPeR(0.0011)| GPeC(0.0004)| GPe(0.0004)| PuPV(0.0004)| PuC(0.0)| Pu(0.0)| PuR(0.0)| SN-VTA(0.0)	Balanced	0	0	0	0	0	0	0.317	4092	10999	2.69
AIT117_303	NN_75		AIT117_361	STR Astrocyte	cluster							5160	2	['AL445259.1', 'WIF1']	['AL445259.1', 'EMX2OS', 'WIF1', 'AC068308.1', 'RHOJ', 'CA8', 'APOE', 'HPSE2', 'SPARCL1', 'GFRA1']	H23.30.001(0.3355)| H20.30.002(0.3031)| H20.30.001(0.2548)| H18.30.001(0.1064)| H19.30.004(0.0002)	Balanced	Balanced	1036_A03 (0.1395)|1036_B03 (0.0984)|1955_B06 (0.0932)|1959_A02 (0.0822)|1042_B06 (0.0748)|1036_C03 (0.0690)|1042_A06 (0.0647)|1042_C06 (0.0578)|1959_C02 (0.0502)|1091_A05 (0.0481)|1955_C06 (0.0362)|1959_B02 (0.0353)|1110_B07 (0.0192)|2006_A05 (0.0186)|930_A05 (0.0155)|847_A04 (0.0153)|930_C05 (0.0145)|822_A01 (0.0122)|2006_B05 (0.0118)|1110_A07 (0.0112)	0.1395	1036_A03 (0.1395)|a total of 10559 cells in this dominant library	NAC(0.6649)| CaH(0.1738)| Pu(0.0864)| CaB(0.0283)| PuR(0.0167)| GPe(0.0141)| GPeR(0.005)| GPeC(0.0027)| PuPV(0.0025)| CaT(0.0021)| GPi(0.0016)| PuC(0.001)| STH(0.0006)| SN(0.0002)| SN-VTA(0.0)	Balanced	0	0	0	0	0	0	0.1038	3004	7110	2.37
AIT117_304	NN_76		AIT117_361	STR Astrocyte	cluster							1197	5	['WIF1', 'FAM198B-AS1', 'CTXND1', 'HPSE2', 'LINC00299']	['WIF1', 'FAM198B-AS1', 'ZNF98', 'CTXND1', 'HPSE2', 'LINC00299', 'GLI3', 'SLC1A3', 'NR2F2-AS1', 'ADGRV1']	H23.30.001(0.406)| H20.30.002(0.2172)| H20.30.001(0.1955)| H18.30.001(0.1813)| H19.30.004(0.0)	Balanced	Balanced	2016_C03 (0.1495)|822_B01 (0.1362)|988_D05 (0.1337)|988_E05 (0.1270)|2018_B01 (0.0802)|2012_C05 (0.0585)|2018_E01 (0.0501)|930_B05 (0.0476)|980_C02 (0.0393)|891_A06 (0.0301)|988_C05 (0.0217)|930_D05 (0.0201)|2018_C01 (0.0167)|2018_A01 (0.0109)|2006_A05 (0.0109)	0.1495	2016_C03 (0.1495)|a total of 8224 cells in this dominant library	PuPV(0.4954)| CaT(0.3033)| PuC(0.0886)| CaB(0.0635)| GPe(0.0209)| CaH(0.0125)| GPeC(0.0058)| Pu(0.0042)| PuR(0.0033)| NAC(0.0017)| SN(0.0008)| GPi(0.0)| GPeR(0.0)| SN-VTA(0.0)| STH(0.0)	Balanced	0	0	0	0	0	0.0114	0.0429	3472	9383	2.7
AIT117_305	NN_77		AIT117_361	STR Astrocyte	cluster							3644	3	['WIF1', 'LUCAT1', 'ZNF98']	['PRDM16-DT', 'WIF1', 'LUCAT1', 'MOXD1', 'ZNF98', 'SLCO1C1', 'ABI3BP', 'HPSE2', 'AL109809.5', 'GFRA1']	H23.30.001(0.4909)| H20.30.002(0.2014)| H20.30.001(0.1652)| H18.30.001(0.1424)| H19.30.004(0.0)	Balanced	Balanced	2006_A05 (0.2141)|897_E03 (0.1485)|1959_B02 (0.1207)|930_C05 (0.0779)|847_A04 (0.0579)|891_A06 (0.0579)|930_E05 (0.0554)|2013_C01 (0.0425)|1955_B06 (0.0403)|1959_C02 (0.0392)|822_A01 (0.0236)|930_A05 (0.0126)	0.2141	2006_A05 (0.2141)|a total of 6477 cells in this dominant library	CaB(0.5184)| CaH(0.3095)| Pu(0.0456)| NAC(0.0428)| PuR(0.0365)| GPe(0.0159)| PuPV(0.0099)| PuC(0.008)| CaT(0.0066)| GPeR(0.0041)| GPeC(0.0022)| STH(0.0003)| SN(0.0003)| GPi(0.0)| SN-VTA(0.0)	Balanced	0	0	0	0	0	0	0.0217	3296.5	8625	2.62
AIT117_306	NN_78		AIT117_361	STR Astrocyte	cluster							377	4	['VAX1', 'SDS', 'GNA14-AS1', 'ZNF98']	['VAX1', 'CHI3L1', 'SPSB1', 'SDS', 'GNA14-AS1', 'ZNF98', 'GNA14', 'ABI3BP', 'PROS1', 'GFRA1']	H20.30.001(0.8568)| H23.30.001(0.1034)| H18.30.001(0.0292)| H20.30.002(0.0106)| H19.30.004(0.0)	Balanced	Balanced	930_E05 (0.4005)|930_C05 (0.3130)|2006_A05 (0.0637)|980_C02 (0.0531)|1036_B03 (0.0345)|930_F05 (0.0186)|988_E05 (0.0159)|1959_B02 (0.0133)|1042_C06 (0.0133)|2013_C01 (0.0133)	0.4005	930_E05 (0.4005)|a total of 5108 cells in this dominant library	CaB(0.4907)| CaH(0.3448)| CaT(0.0531)| NAC(0.0531)| PuR(0.0212)| PuPV(0.0159)| GPeR(0.008)| PuC(0.0053)| Pu(0.0027)| GPe(0.0027)| GPeC(0.0027)| GPi(0.0)| SN(0.0)| SN-VTA(0.0)| STH(0.0)	Balanced	0	0	0	0	0	0	0.0184	3098	9144	2.95
AIT117_307	NN_79		AIT117_361	STR Astrocyte	cluster							3990	3	['LINC00499', 'COL5A3', 'AL137139.2']	['LINC00499', 'OAF', 'WIF1', 'COL5A3', 'AL137139.2', 'SLCO1C1', 'HPSE2', 'GLI3', 'SHROOM3', 'SLC1A3']	H23.30.001(0.3907)| H20.30.001(0.2862)| H20.30.002(0.191)| H18.30.001(0.1316)| H19.30.004(0.0005)	Balanced	Balanced	988_E05 (0.1248)|2018_A01 (0.0855)|930_D05 (0.0754)|2016_B03 (0.0644)|930_F05 (0.0564)|2018_B01 (0.0559)|988_C05 (0.0524)|822_B01 (0.0474)|1959_C02 (0.0388)|988_D05 (0.0351)|822_A01 (0.0348)|1955_C06 (0.0326)|2016_C03 (0.0296)|847_D04 (0.0291)|1959_A02 (0.0281)|847_C04 (0.0273)|1042_A06 (0.0218)|930_B05 (0.0201)|1091_A05 (0.0138)|2006_A05 (0.0105)	0.1248	988_E05 (0.1248)|a total of 10190 cells in this dominant library	PuPV(0.285)| PuC(0.2744)| CaT(0.104)| PuR(0.0962)| NAC(0.0875)| Pu(0.0714)| CaB(0.0316)| CaH(0.0266)| GPe(0.0153)| GPeC(0.0045)| GPeR(0.0018)| GPi(0.0013)| STH(0.0005)| SN(0.0)| SN-VTA(0.0)	Balanced	0	0	0	0	0	0	0.0456	3068.5	7636	2.49
AIT117_308	NN_80		AIT117_361	STR Astrocyte	cluster							340	6	['OSGIN2', 'AL137139.2', 'ETNPPL', 'SLC14A1', 'ALDH1A1', 'GINS3']	['OSGIN2', 'AL137139.2', 'ETNPPL', 'SLC14A1', 'ALDH1A1', 'GINS3', 'CST3', 'AC012405.1', 'GLI3', 'SHROOM3']	H20.30.001(0.3118)| H23.30.001(0.2971)| H18.30.001(0.2294)| H20.30.002(0.1618)| H19.30.004(0.0)	Balanced	Balanced	988_E05 (0.1441)|988_D05 (0.1294)|930_D05 (0.1206)|822_B01 (0.1118)|2018_B01 (0.1000)|2012_C05 (0.0529)|2018_A01 (0.0382)|930_F05 (0.0382)|847_C04 (0.0324)|891_A06 (0.0265)|2018_E01 (0.0265)|988_C05 (0.0235)|2016_C03 (0.0206)|2018_C01 (0.0206)|1959_C02 (0.0147)|822_A01 (0.0147)|853_B07 (0.0147)|847_D04 (0.0147)	0.1441	988_E05 (0.1441)|a total of 10190 cells in this dominant library	PuPV(0.4088)| CaT(0.2353)| PuC(0.1912)| PuR(0.0559)| CaB(0.0324)| GPe(0.0206)| Pu(0.0176)| GPeC(0.0147)| CaH(0.0147)| NAC(0.0059)| GPeR(0.0029)| GPi(0.0)| SN(0.0)| SN-VTA(0.0)| STH(0.0)	Balanced	0	0	0	0	0	0	0.063	2989.5	7326	2.45
AIT117_309	NN_81		AIT117_361	STR Astrocyte	cluster							1648	2	['CLCF1', 'IL1R1']	['CLCF1', 'CHI3L1', 'EMP1', 'SDS', 'IL1R1', 'LDLR', 'OAF', 'F3', 'CXCL14', 'AC016831.1']	H20.30.001(0.9654)| H23.30.001(0.0194)| H20.30.002(0.0079)| H18.30.001(0.0061)| H19.30.004(0.0012)	Cautious	Balanced	988_E05 (0.3762)|930_D05 (0.3343)|930_F05 (0.2215)|980_C02 (0.0140)	0.3762	988_E05 (0.3762)|a total of 10190 cells in this dominant library	PuPV(0.3792)| PuC(0.3404)| PuR(0.2227)| CaT(0.0212)| CaH(0.0115)| CaB(0.0109)| NAC(0.0079)| Pu(0.0024)| SN(0.0012)| STH(0.0012)| GPe(0.0006)| GPeR(0.0006)| GPeC(0.0)| GPi(0.0)| SN-VTA(0.0)	Balanced	0	0	0	0	0	0.02	0.0711	3043.5	9077.5	2.98
AIT117_310	NN_82		AIT117_348	BN Astrocyte	cluster							644	3	['EGLN3', 'AC114971.1', 'PLSCR4']	['RANBP3L', 'COLEC12', 'EGLN3', 'AC114971.1', 'PLSCR4', 'HPSE2', 'AC091826.2', 'AF279873.3', 'ADGRA3', 'SPARCL1']	H20.30.001(0.455)| H23.30.001(0.278)| H20.30.002(0.2174)| H18.30.001(0.0497)| H19.30.004(0.0)	Balanced	Balanced	1482_A03 (0.4348)|988_C05 (0.1708)|2016_C03 (0.0730)|2012_B05 (0.0668)|2018_C01 (0.0543)|930_B05 (0.0311)|2012_A05 (0.0264)|925_F03 (0.0217)|2016_A03 (0.0140)|2013_A01 (0.0109)	0.4348	1482_A03 (0.4348)|a total of 4968 cells in this dominant library	GPi(0.5404)| CaT(0.1832)| GPe(0.0916)| PuPV(0.0807)| NAC(0.0388)| PuC(0.0326)| SN(0.0233)| CaB(0.0047)| GPeC(0.0047)| GPeR(0.0)| CaH(0.0)| Pu(0.0)| PuR(0.0)| SN-VTA(0.0)| STH(0.0)	Balanced	0	0	0	0	0	0.02	0.0297	3008	7976	2.65
AIT117_311	NN_83		AIT117_348	BN Astrocyte	cluster							493	3	['AC087477.2', 'AL137139.2', 'PTCH1']	['AC087477.2', 'AL137139.2', 'AC068308.1', 'ANGPT1', 'PTCH1', 'AF279873.3', 'NRP2', 'TAFA1', 'NR2F2-AS1', 'PTN']	H20.30.002(0.5963)| H18.30.001(0.3124)| H23.30.001(0.0568)| H20.30.001(0.0284)| H19.30.004(0.0061)	Balanced	Balanced	988_C05 (0.5943)|925_F03 (0.3043)|2016_C03 (0.0264)|1482_A03 (0.0223)|1959_A02 (0.0142)	0.5943	988_C05 (0.5943)|a total of 5279 cells in this dominant library	CaT(0.6045)| SN(0.3043)| PuPV(0.0345)| GPi(0.0264)| NAC(0.0183)| STH(0.0061)| GPe(0.0061)| GPeR(0.0)| GPeC(0.0)| CaB(0.0)| CaH(0.0)| PuC(0.0)| Pu(0.0)| PuR(0.0)| SN-VTA(0.0)	Balanced	0	0	0	0	0	0.0143	0.1508	2845	6639	2.33
AIT117_312	NN_84		AIT117_361	STR Astrocyte	cluster							176	2	['AL137139.2', 'EGLN3']	['AC090993.1', 'THSD1', 'AC087477.2', 'WIF1', 'AL137139.2', 'EGLN3', 'ADAMTS17', 'CCBE1', 'AC087854.1', 'AF279873.3']	H23.30.001(0.75)| H20.30.002(0.1932)| H18.30.001(0.0341)| H20.30.001(0.0227)| H19.30.004(0.0)	Balanced	Balanced	2016_C03 (0.7159)|988_C05 (0.1364)|930_B05 (0.0511)|988_D05 (0.0227)|2018_C01 (0.0227)|1482_A03 (0.0227)|925_F03 (0.0114)	0.7159	2016_C03 (0.7159)|a total of 8224 cells in this dominant library	PuPV(0.7216)| CaT(0.1648)| PuC(0.0511)| GPi(0.0227)| GPe(0.0227)| SN(0.0114)| NAC(0.0057)| GPeR(0.0)| GPeC(0.0)| CaB(0.0)| CaH(0.0)| Pu(0.0)| PuR(0.0)| SN-VTA(0.0)| STH(0.0)	Balanced	0	0	0	0	0	0.02	0.0476	3559	10286.5	2.89
AIT117_313	SN STH GABA		AIT117_364	SN STH GABA	Group																												
AIT117_314	SN STH VTA Glut		AIT117_365	BG Glut	Group																												
AIT117_315	STR Cholinergic GABA		AIT117_366	STR Cholinergic GABA	Group																												
AIT117_316	NDB SI LHX8 GABA		AIT117_367	CN LHX6 LHX8 GABA	Group																												
AIT117_317	SN STH PVALB PITX2 Glut		AIT117_365	BG Glut	Group																												
AIT117_318	SN STH GATA3 TCF7L2 GABA		AIT117_364	SN STH GABA	Group																												
AIT117_319	SN PVALB GATA3 GABA		AIT117_368	SN PVALB GABA	Group																												
AIT117_320	TH MEIS2 OTX2 GABA		AIT117_369	TH MEIS2 GABA	Group																												
AIT117_321	STR FS PTHLH ST18 GABA		AIT117_370	BG PVALB GABA	Group																												
AIT117_322	STR TAC3 PLPP4 GABA		AIT117_367	CN LHX6 LHX8 GABA	Group																												
AIT117_323	NDB SI LHX6 LHX8 GBX1		AIT117_367	CN LHX6 LHX8 GABA	Group																												
AIT117_324	SN TH Dopa		AIT117_371	SN TH Dopa	Group																												
AIT117_325	GPi Shell		AIT117_372	GP GABA Glut	Group																												
AIT117_326	BN LAMP5 CXCL14 GABA		AIT117_373	CN MGE LAMP5 GABA	Group																												
AIT117_327	STR VIP GABA		AIT117_374	CN CGE VIP GABA	Group																												
AIT117_328	GPi Core		AIT117_375	GP PVALB GABA	Group																												
AIT117_329	BG SKOR1 Glut		AIT117_365	BG Glut	Group																												
AIT117_330	STR LHX8 ST18 GABA		AIT117_367	CN LHX6 LHX8 GABA	Group																												
AIT117_331	STR SST RSPO2 GABA		AIT117_376	STR SST GABA	Group																												
AIT117_332	STR SST Chodl GABA		AIT117_376	STR SST GABA	Group																												
AIT117_333	BN LAMP5 LHX6 GABA		AIT117_373	CN MGE LAMP5 GABA	Group																												
AIT117_334	GP MEIS2 SOX6 GABA		AIT117_377	BN MEIS2 GABA	Group																												
AIT117_335	GP SOX6 KCNA1 GABA		AIT117_367	CN LHX6 LHX8 GABA	Group																												
AIT117_336	BN MEIS2 GABA		AIT117_377	BN MEIS2 GABA	Group																												
AIT117_337	STR SST ADARB2 GABA		AIT117_376	STR SST GABA	Group																												
AIT117_338	STRd D2 Matrix		AIT117_378	STR D2 MSN GABA	Group	CL:4030047	matrix D2 medium spiny neuron																										
AIT117_339	STRv D2 Shell		AIT117_378	STR D2 MSN GABA	Group	CL:4030052	nucleus accumbens shell and olfactory tubercle D2 medium spiny neuron																										
AIT117_340	STRv D1 Shell		AIT117_379	STR D1 MSN GABA	Group	CL:4030051	nucleus accumbens shell and olfactory tubercle D1 medium spiny neuron																										
AIT117_341	STRd D1 Matrix		AIT117_379	STR D1 MSN GABA	Group	CL:4030043	matrix D1 medium spiny neuron																										
AIT117_342	STRd D1 Striosome		AIT117_379	STR D1 MSN GABA	Group	CL:4030048	striosomal D1 medium spiny neuron																										
AIT117_343	STRd D2 Striosome		AIT117_378	STR D2 MSN GABA	Group	CL:4030049	striosomal D2 medium spiny neuron																										
AIT117_344	STRd D1D2 Hybrid		AIT117_380	STR Hybrid MSN GABA	Group	CL:4030050	D1/D2-hybrid medium spiny neuron																										
AIT117_345	STRv D1 NUDAP		AIT117_380	STR Hybrid MSN GABA	Group	CL:4030054	RXFP1-positive interface island D1-medium spiny neuron																										
AIT117_346	STRd D2 StrioMat Hybrid		AIT117_378	STR D2 MSN GABA	Group																												
AIT117_347	OT D1-ICj		AIT117_381	STR Granular GABA	Group	CL:4030053	Island of Calleja granule cell																										
AIT117_348	BN Astrocyte		AIT117_382	Astrocyte	Group																												
AIT117_349	Oligo RBFOX1		AIT117_383	Oligodendrocyte	Group																												
AIT117_350	Oligo OPALIN		AIT117_383	Oligodendrocyte	Group																												
AIT117_351	COP		AIT117_384	COP	Group																												
AIT117_352	OPC		AIT117_385	OPC	Group																												
AIT117_353	Microglia		AIT117_386	Microglia	Group																												
AIT117_354	Endo		AIT117_387	Endo	Group																												
AIT117_355	SMC		AIT117_388	SMC	Group																												
AIT117_356	Pericyte		AIT117_389	Pericyte	Group																												
AIT117_357	VLMC		AIT117_390	VLMC	Group																												
AIT117_358	T cells		AIT117_391	Lymphocyte	Group	CL:0000084	T cell																										
AIT117_359	NK cells		AIT117_391	Lymphocyte	Group	CL:0000623	natural killer cell																										
AIT117_360	BAM		AIT117_392	Macrophage	Group	CL:4042003	border associated macrophage																										
AIT117_361	STR Astrocyte		AIT117_382	Astrocyte	Group	CL:0000127	astrocyte																										
AIT117_362	ImOligo		AIT117_393	ImOligo	Group																												
AIT117_363	Ependymal		AIT117_394	Ependymal	Group																												
AIT117_364	SN STH GABA		AIT117_395	CN MGE GABA	Subclass																												
AIT117_365	BG Glut		AIT117_396	F M Glut	Subclass																												
AIT117_366	STR Cholinergic GABA		AIT117_395	CN MGE GABA	Subclass																												
AIT117_367	CN LHX6 LHX8 GABA		AIT117_395	CN MGE GABA	Subclass																												
AIT117_368	SN PVALB GABA		AIT117_395	CN MGE GABA	Subclass																												
AIT117_369	TH MEIS2 GABA		AIT117_395	CN MGE GABA	Subclass																												
AIT117_370	BG PVALB GABA		AIT117_395	CN MGE GABA	Subclass																												
AIT117_371	SN TH Dopa		AIT117_397	MB Dopaminergic	Subclass																												
AIT117_372	GP GABA Glut		AIT117_398	BG GABA Glut	Subclass																												
AIT117_373	CN MGE LAMP5 GABA		AIT117_395	CN MGE GABA	Subclass																												
AIT117_374	CN CGE VIP GABA		AIT117_399	CN CGE GABA	Subclass																												
AIT117_375	GP PVALB GABA		AIT117_395	CN MGE GABA	Subclass																												
AIT117_376	STR SST GABA		AIT117_395	CN MGE GABA	Subclass																												
AIT117_377	BN MEIS2 GABA		AIT117_395	CN MGE GABA	Subclass																												
AIT117_378	STR D2 MSN GABA		AIT117_400	CN LGE GABA	Subclass	CL:4023029	indirect pathway medium spiny neuron																										
AIT117_379	STR D1 MSN GABA		AIT117_400	CN LGE GABA	Subclass	CL:4023026	direct pathway medium spiny neuron																										
AIT117_380	STR Hybrid MSN GABA		AIT117_400	CN LGE GABA	Subclass	CL:4030050	D1/D2-hybrid medium spiny neuron																										
AIT117_381	STR Granular GABA		AIT117_400	CN LGE GABA	Subclass	CL:4030053	Island of Calleja granule cell																										
AIT117_382	Astrocyte		AIT117_401	Astro-Epen	Subclass	CL:0000127	astrocyte																										
AIT117_383	Oligodendrocyte		AIT117_402	OPC-Oligo	Subclass	CL:0000128	oligodendrocyte																										
AIT117_384	COP		AIT117_402	OPC-Oligo	Subclass	CL:4023059	differentiation-committed oligodendrocyte precursor																										
AIT117_385	OPC		AIT117_402	OPC-Oligo	Subclass	CL:0002453	oligodendrocyte precursor cell																										
AIT117_386	Microglia		AIT117_403	Immune	Subclass	CL:0000129	microglial cell																										
AIT117_387	Endo		AIT117_404	Vascular	Subclass	CL:0000115	endothelial cell																										
AIT117_388	SMC		AIT117_404	Vascular	Subclass	CL:0000192	smooth muscle cell																										
AIT117_389	Pericyte		AIT117_404	Vascular	Subclass	CL:0000669	pericyte																										
AIT117_390	VLMC		AIT117_404	Vascular	Subclass	CL:4023051	vascular leptomeningeal cell																										
AIT117_391	Lymphocyte		AIT117_403	Immune	Subclass	CL:0000542	lymphocyte																										
AIT117_392	Macrophage		AIT117_403	Immune	Subclass	CL:0000235	macrophage																										
AIT117_393	ImOligo		AIT117_402	OPC-Oligo	Subclass																												
AIT117_394	Ependymal		AIT117_401	Astro-Epen	Subclass	CL:0000065	ependymal cell																										
AIT117_395	CN MGE GABA		AIT117_405	Subpallium GABA	Class																												
AIT117_396	F M Glut		AIT117_406	Glut Sero Dopa	Class																												
AIT117_397	MB Dopaminergic		AIT117_406	Glut Sero Dopa	Class	CL:2000097	midbrain dopaminergic neuron																										
AIT117_398	BG GABA Glut		AIT117_407	GABA Glut	Class																												
AIT117_399	CN CGE GABA		AIT117_405	Subpallium GABA	Class																												
AIT117_400	CN LGE GABA		AIT117_405	Subpallium GABA	Class																												
AIT117_401	Astro-Epen		AIT117_408	Nonneuron	Class	CL:0000125	glial cell																										
AIT117_402	OPC-Oligo		AIT117_408	Nonneuron	Class	CL:0000095	neuron associated cell																										
AIT117_403	Immune		AIT117_408	Nonneuron	Class	CL:0000842	mononuclear cell																										
AIT117_404	Vascular		AIT117_408	Nonneuron	Class																												
AIT117_405	Subpallium GABA				Neighborhood																												
AIT117_406	Glut Sero Dopa				Neighborhood																												
AIT117_407	GABA Glut				Neighborhood																												
AIT117_408	Nonneuron				Neighborhood	CL:0000000	cell																										
